id;total_personas;personas15_65;personas65;padron;long;lat;urbano
1;1515;1124;89;1213;-70,76197943;-33,46607326;1
2;71;53;0;53;-70,76158861;-33,46480329;1
3;178;127;12;139;-70,75890477;-33,46490555;1
4;109;82;5;87;-70,75770348;-33,46512116;1
5;288;215;11;226;-70,75718668;-33,46601263;1
6;155;116;8;124;-70,7589031;-33,46529718;1
7;259;193;18;211;-70,75679311;-33,46605333;1
8;164;113;18;131;-70,76095739;-33,46529323;1
9;209;156;13;169;-70,75645575;-33,46609138;1
10;217;182;10;192;-70,75612221;-33,46613711;1
11;205;163;11;174;-70,75579186;-33,46617805;1
12;103;87;0;87;-70,75801059;-33,46568892;1
13;228;175;15;190;-70,7554435;-33,46620041;1
14;223;167;17;184;-70,75765107;-33,46615326;1
15;126;96;0;96;-70,75508555;-33,46627591;1
16;183;141;9;150;-70,75923353;-33,46610304;1
17;69;51;0;51;-70,76125823;-33,46568208;1
18;145;126;7;133;-70,75856344;-33,46620664;1
19;73;54;4;58;-70,75311739;-33,46651934;1
20;107;78;11;89;-70,75142938;-33,46627413;1
21;103;79;8;87;-70,75813903;-33,46649573;1
22;86;61;8;69;-70,75008435;-33,46650631;1
23;109;89;0;89;-70,75150437;-33,46661149;1
24;91;73;5;78;-70,74894201;-33,46670735;1
25;39;29;4;33;-70,76127592;-33,46662837;1
26;98;72;6;78;-70,76042097;-33,46665012;1
27;78;68;0;68;-70,75017203;-33,46684315;1
28;101;83;10;93;-70,75263355;-33,46712668;1
29;221;167;18;185;-70,74802913;-33,46787944;1
30;128;107;6;113;-70,75158871;-33,46692953;1
31;88;66;11;77;-70,74690428;-33,4670716;1
32;91;70;10;80;-70,74902202;-33,46704427;1
33;90;76;0;76;-70,75024686;-33,46716039;1
34;182;151;9;160;-70,75845821;-33,46708176;1
35;53;41;7;48;-70,74606239;-33,46734442;1
36;77;61;0;61;-70,75229534;-33,46735282;1
37;57;47;5;52;-70,76106664;-33,46723824;1
38;77;59;0;59;-70,75191547;-33,46741952;1
39;115;90;6;96;-70,74542856;-33,46792024;1
40;110;89;5;94;-70,74910602;-33,46736223;1
41;67;55;5;60;-70,75153403;-33,4674864;1
42;310;239;15;254;-70,75753752;-33,46830279;1
43;88;61;7;68;-70,74701353;-33,467411;1
44;115;93;6;99;-70,7450416;-33,46798082;1
45;168;132;9;141;-70,75627956;-33,46720512;1
46;53;42;0;42;-70,75114977;-33,4675503;1
47;80;61;0;61;-70,76025481;-33,46733567;1
48;113;92;0;92;-70,75527568;-33,46753335;1
49;106;78;9;87;-70,75494865;-33,46754556;1
50;97;68;8;76;-70,74464629;-33,46803538;1
51;106;80;4;84;-70,75461246;-33,46755973;1
52;64;48;7;55;-70,75073711;-33,46762309;1
53;111;84;8;92;-70,74423511;-33,46811551;1
54;69;49;0;49;-70,75035511;-33,46768951;1
55;139;108;6;114;-70,75899408;-33,4676687;1
56;107;82;15;97;-70,74384791;-33,46818649;1
57;89;67;0;67;-70,7584399;-33,46744742;1
58;65;52;6;58;-70,74997416;-33,46775831;1
59;181;143;10;153;-70,75633118;-33,46748683;1
60;118;95;0;95;-70,74345431;-33,46824735;1
61;111;84;4;88;-70,75790843;-33,46784347;1
62;60;49;6;55;-70,74959499;-33,46782214;1
63;65;55;0;55;-70,74712617;-33,4677273;1
64;111;78;9;87;-70,74303268;-33,46831168;1
65;52;43;0;43;-70,74921787;-33,46788811;1
66;115;86;14;100;-70,74231577;-33,46831279;1
67;29;23;0;23;-70,74883356;-33,46795155;1
68;80;63;0;63;-70,74640555;-33,46816947;1
69;101;69;12;81;-70,75364401;-33,46782437;1
70;84;66;8;74;-70,74587541;-33,4681896;1
71;126;94;9;103;-70,74112337;-33,46811204;1
72;166;125;11;136;-70,75637498;-33,46776802;1
73;56;44;0;44;-70,75843974;-33,46781287;1
74;64;50;0;50;-70,74724161;-33,46804753;1
75;157;120;11;131;-70,75231854;-33,46885632;1
76;60;54;0;54;-70,73974171;-33,46835485;1
77;92;68;11;79;-70,74265567;-33,46857499;1
78;185;149;14;163;-70,75429451;-33,46883864;1
79;201;148;11;159;-70,75641535;-33,46804871;1
80;140;112;6;118;-70,75193134;-33,46891691;1
81;130;94;6;100;-70,75492661;-33,46811328;1
82;144;118;0;118;-70,75390444;-33,46887239;1
83;161;132;11;143;-70,75154156;-33,46894507;1
84;116;86;12;98;-70,74117369;-33,46847218;1
85;105;75;11;86;-70,73899968;-33,46897233;1
86;125;102;10;112;-70,75352332;-33,46892277;1
87;19;14;0;14;-70,75844003;-33,46848798;0
88;53;38;0;38;-70,74735229;-33,46836333;1
89;157;124;6;130;-70,75112201;-33,46898029;1
90;119;90;10;100;-70,76030064;-33,46816039;1
91;138;104;12;116;-70,75313662;-33,46896408;1
92;134;103;11;114;-70,75072971;-33,46902394;1
93;82;62;13;75;-70,73854302;-33,46903771;1
94;134;112;5;117;-70,75275116;-33,46899988;1
95;50;41;0;41;-70,74648556;-33,46848943;1
96;140;112;0;112;-70,75034581;-33,4690682;1
97;70;55;5;60;-70,73811987;-33,4690591;1
98;127;101;8;109;-70,75884406;-33,46864344;1
99;161;116;6;122;-70,75645361;-33,4683294;1
100;140;98;16;114;-70,74996222;-33,46911002;1
101;114;82;6;88;-70,75497727;-33,46839544;1
102;70;52;5;57;-70,73977234;-33,46872189;1
103;124;97;0;97;-70,74957951;-33,46914841;1
104;59;46;5;51;-70,73762928;-33,46914394;1
105;95;71;11;82;-70,74122046;-33,46879232;1
106;117;94;6;100;-70,74917727;-33,46919065;1
107;100;82;0;82;-70,74724085;-33,46878769;1
108;101;79;4;83;-70,75805451;-33,46876703;1
109;131;84;22;106;-70,74823584;-33,46932914;1
110;161;130;6;136;-70,75650353;-33,46861079;1
111;116;89;6;95;-70,75504451;-33,46867286;1
112;109;82;11;93;-70,74632674;-33,46937397;1
113;79;57;10;67;-70,73979587;-33,46904689;1
114;121;86;11;97;-70,74594109;-33,46939137;1
115;118;92;11;103;-70,74550542;-33,46941347;1
116;113;91;4;95;-70,76016455;-33,46889183;1
117;105;82;7;89;-70,74511817;-33,4694402;1
118;87;76;0;76;-70,74127574;-33,46911238;1
119;85;59;7;66;-70,74473125;-33,46946447;1
120;80;61;0;61;-70,74430347;-33,46951688;1
121;193;156;11;167;-70,756545;-33,46889236;1
122;77;58;7;65;-70,74879293;-33,46940123;1
123;93;72;10;82;-70,74391434;-33,46954898;1
124;114;90;8;98;-70,75509515;-33,46895124;1
125;74;60;0;60;-70,74352385;-33,46959151;1
126;72;55;0;55;-70,74718402;-33,46916004;1
127;70;48;12;60;-70,73982054;-33,46937171;1
128;85;72;4;76;-70,74271277;-33,46967257;1
129;86;64;9;73;-70,74231005;-33,46969874;1
130;103;86;5;91;-70,74132062;-33,46948209;1
131;162;131;5;136;-70,75659003;-33,46917554;1
132;124;91;5;96;-70,7551492;-33,46923511;1
133;73;59;0;59;-70,7472072;-33,46948771;1
134;101;73;6;79;-70,758442;-33,46935962;1
135;46;30;11;41;-70,74013922;-33,46994986;1
136;201;157;0;157;-70,75662922;-33,46947665;1
137;97;76;8;84;-70,74136956;-33,46980136;1
138;102;78;7;85;-70,75521512;-33,46953735;1
139;41;25;0;25;-70,73945997;-33,46990231;1
140;190;142;21;163;-70,73822837;-33,47097241;1
141;1481;1060;156;1216;-70,73307862;-33,47112141;1
142;82;66;8;74;-70,73940038;-33,47031533;1
143;92;61;11;72;-70,74726271;-33,46983798;1
144;63;49;8;57;-70,7403459;-33,47030405;1
145;26;22;0;22;-70,74150477;-33,47010287;1
146;221;180;5;185;-70,7604655;-33,46998308;1
147;140;100;9;109;-70,75893343;-33,46985336;1
148;231;176;21;197;-70,75621893;-33,47180156;1
149;100;79;7;86;-70,75506415;-33,46999759;1
150;25;19;0;19;-70,7389677;-33,47047576;0
151;152;110;7;117;-70,75435321;-33,47058055;1
152;152;113;9;122;-70,75404289;-33,47058318;1
153;129;107;0;107;-70,75372967;-33,47060425;1
154;169;127;17;144;-70,75261243;-33,4700986;1
155;97;75;6;81;-70,75090755;-33,47015931;1
156;91;57;13;70;-70,74745763;-33,47029693;1
157;33;25;4;29;-70,74651673;-33,47035894;1
158;171;116;23;139;-70,74593747;-33,47104629;1
159;143;112;6;118;-70,75919608;-33,47023633;1
160;60;46;6;52;-70,74552454;-33,47055411;1
161;56;45;5;50;-70,74510911;-33,47058403;1
162;137;102;18;120;-70,74475868;-33,47108719;1
163;144;105;19;124;-70,74436817;-33,47109636;1
164;121;91;4;95;-70,75506157;-33,47028901;1
165;146;105;19;124;-70,74397605;-33,4711244;1
166;134;100;14;114;-70,74358045;-33,47113645;1
167;126;99;15;114;-70,74222447;-33,47054466;1
168;117;101;4;105;-70,7533788;-33,47078082;1
169;145;113;7;120;-70,7530452;-33,47080535;1
170;146;110;14;124;-70,7491311;-33,47047274;1
171;112;84;9;93;-70,75166921;-33,47086585;1
172;491;357;26;383;-70,73016327;-33,47141467;1
173;134;106;8;114;-70,75271407;-33,47082945;1
174;43;34;0;34;-70,74090292;-33,47068201;1
175;118;96;0;96;-70,75133076;-33,47089367;1
176;137;110;6;116;-70,75238011;-33,47085241;1
177;94;75;8;83;-70,75099864;-33,47091617;1
178;127;98;6;104;-70,75204932;-33,47087621;1
179;92;67;12;79;-70,75066682;-33,47093518;1
180;112;92;5;97;-70,75033348;-33,47096596;1
181;66;50;10;60;-70,74750657;-33,47058601;1
182;57;45;0;45;-70,75779395;-33,4706856;1
183;107;86;10;96;-70,74021769;-33,47110883;1
184;42;30;0;30;-70,74652455;-33,47065743;1
185;58;48;5;53;-70,75504447;-33,47055876;1
186;27;16;0;16;-70,7352897;-33,47116502;0
187;98;84;7;91;-70,74915464;-33,47073084;1
188;134;91;7;98;-70,75816475;-33,47237009;1
189;79;62;0;62;-70,75869361;-33,47064693;1
190;139;108;13;121;-70,74236176;-33,47088958;1
191;87;63;8;71;-70,74753924;-33,47084618;1
192;150;118;7;125;-70,74059004;-33,47133387;1
193;51;36;7;43;-70,74652409;-33,47091713;1
194;69;61;0;61;-70,75502677;-33,47082685;1
195;142;107;9;116;-70,74919999;-33,47099188;1
196;53;33;10;43;-70,74532962;-33,47108218;1
197;67;49;0;49;-70,7475741;-33,47111168;1
198;114;85;15;100;-70,74249725;-33,47120576;1
199;62;42;15;57;-70,734666;-33,47176213;1
200;92;69;17;86;-70,72904846;-33,47176682;1
201;139;102;16;118;-70,74080031;-33,47160269;1
202;56;44;0;44;-70,74652438;-33,47118807;1
203;120;85;20;105;-70,73558863;-33,47216003;1
204;58;37;9;46;-70,75500935;-33,47109795;1
205;126;105;0;105;-70,74922384;-33,47124783;1
206;102;78;16;94;-70,72858847;-33,47203265;1
207;91;70;9;79;-70,74761669;-33,47136596;1
208;42;33;6;39;-70,74532404;-33,47140913;1
209;54;35;10;45;-70,73511279;-33,47198801;1
210;132;111;0;111;-70,74101089;-33,47187672;1
211;95;68;15;83;-70,74262713;-33,47152453;1
212;0;0;0;0;-70,74652498;-33,47158323;0
213;89;59;24;83;-70,73678008;-33,4722014;1
214;194;143;16;159;-70,74004232;-33,47237178;1
215;133;95;15;110;-70,74927023;-33,47150618;1
216;129;104;7;111;-70,75479571;-33,47192742;1
217;17;13;0;13;-70,72706632;-33,47209093;0
218;148;112;8;120;-70,75448441;-33,47194406;1
219;126;97;13;110;-70,75418024;-33,47197196;1
220;98;78;9;87;-70,75387106;-33,47199221;1
221;93;70;12;82;-70,74764226;-33,47162382;1
222;125;96;12;108;-70,75279098;-33,47156489;1
223;56;33;14;47;-70,726369;-33,47211258;1
224;150;124;11;135;-70,7412242;-33,47215072;1
225;40;32;0;32;-70,74531849;-33,4717301;1
226;38;26;0;26;-70,73897691;-33,47196929;1
227;151;118;8;126;-70,75107358;-33,47168393;1
228;92;62;11;73;-70,7277874;-33,47234113;1
229;58;48;5;53;-70,74275016;-33,47184785;1
230;133;93;6;99;-70,74931672;-33,47181278;1
231;137;117;7;124;-70,7528219;-33,47182951;1
232;58;40;12;52;-70,73598111;-33,4724262;1
233;80;56;11;67;-70,72542352;-33,47239316;1
234;77;58;0;58;-70,7476903;-33,47192778;1
235;59;46;6;52;-70,73914221;-33,4722365;1
236;148;111;10;121;-70,74143698;-33,47242269;1
237;132;103;10;113;-70,75111121;-33,47195241;1
238;60;42;7;49;-70,74653175;-33,47201759;1
239;143;111;15;126;-70,74452562;-33,47213118;1
240;47;36;0;36;-70,7264751;-33,47245991;1
241;160;119;16;135;-70,74577503;-33,47293309;1
242;143;110;10;120;-70,74934537;-33,47207544;1
243;31;24;7;31;-70,73452622;-33,47254396;1
244;82;66;0;66;-70,75284695;-33,47208806;1
245;56;40;7;47;-70,73072826;-33,47267219;1
246;77;58;8;66;-70,73175582;-33,47281254;1
247;50;39;0;39;-70,73658541;-33,47270823;1
248;51;36;8;44;-70,7324383;-33,47243812;1
249;138;107;16;123;-70,73893718;-33,47303669;1
250;82;72;4;76;-70,74772108;-33,47219404;1
251;71;49;12;61;-70,72493162;-33,4728711;1
252;97;79;0;79;-70,73288521;-33,47295365;1
253;64;47;10;57;-70,73935816;-33,47252427;1
254;133;105;9;114;-70,75113386;-33,47221452;1
255;46;36;7;43;-70,74653346;-33,47228503;1
256;120;95;12;107;-70,74167643;-33,47272207;1
257;66;43;10;53;-70,72562942;-33,4727113;1
258;116;93;0;93;-70,73023642;-33,47311848;1
259;37;23;10;33;-70,72739121;-33,47286634;1
260;140;112;8;120;-70,74937672;-33,47233663;1
261;71;60;0;60;-70,73334499;-33,47313831;1
262;67;46;14;60;-70,72821977;-33,47295908;1
263;151;113;14;127;-70,7444836;-33,47246156;1
264;80;52;13;65;-70,72671658;-33,47305439;1
265;27;19;4;23;-70,72779108;-33,47286934;1
266;38;29;0;29;-70,72646985;-33,47278649;1
267;98;78;6;84;-70,75286896;-33,47234906;1
268;98;62;19;81;-70,72403741;-33,47282255;1
269;105;81;9;90;-70,74777278;-33,47245135;1
270;125;91;14;105;-70,75188125;-33,47292384;1
271;81;70;7;77;-70,73957589;-33,47280783;1
272;69;53;7;60;-70,74653326;-33,47254492;1
273;132;98;10;108;-70,75154359;-33,47294785;1
274;131;88;19;107;-70,74188124;-33,47299559;1
275;144;110;8;118;-70,75121581;-33,4729699;1
276;115;95;9;104;-70,75088464;-33,47298896;1
277;116;91;9;100;-70,75054443;-33,47301802;1
278;95;69;9;78;-70,73382879;-33,47332372;1
279;69;52;9;61;-70,72853448;-33,47316724;1
280;42;31;4;35;-70,73627252;-33,47303808;1
281;30;20;0;20;-70,73232201;-33,47286098;0
282;44;30;5;35;-70,72580459;-33,47298776;1
283;125;98;0;98;-70,75289964;-33,47260827;1
284;80;49;0;49;-70,79577474;-33,50360615;1
285;202;122;31;153;-70,76835718;-33,50458834;1
286;47;28;12;40;-70,72325962;-33,47324015;1
287;73;55;0;55;-70,76908932;-33,5040618;1
288;148;107;16;123;-70,74446276;-33,47278514;1
289;40;26;9;35;-70,77804245;-33,5038678;1
290;98;71;9;80;-70,74778324;-33,47271201;1
291;381;245;12;257;-70,78600821;-33,5046489;1
292;27;18;0;18;-70,73566505;-33,47300846;0
293;51;30;11;41;-70,76970604;-33,50411072;1
294;75;50;16;66;-70,77058215;-33,50409265;1
295;81;60;0;60;-70,78699754;-33,50391761;1
296;235;154;5;159;-70,78604887;-33,50372449;1
297;20;16;0;16;-70,79532852;-33,50374864;0
298;77;52;0;52;-70,7972856;-33,50354106;1
299;99;62;18;80;-70,77296477;-33,50420014;1
300;120;84;0;84;-70,79231893;-33,50374882;1
301;49;27;14;41;-70,77760697;-33,50409257;1
302;52;25;14;39;-70,7481861;-33,50445739;1
303;89;59;0;59;-70,79623677;-33,50381532;1
304;109;70;16;86;-70,73823635;-33,5045859;1
305;88;63;0;63;-70,7851028;-33,50405158;1
306;22;15;4;19;-70,7457548;-33,50445712;0
307;34;19;10;29;-70,74653568;-33,50471402;1
308;99;74;4;78;-70,79370671;-33,50379879;1
309;79;54;0;54;-70,79654614;-33,50389675;1
310;66;37;21;58;-70,7771696;-33,50429703;1
311;168;109;25;134;-70,74256141;-33,50505022;1
312;164;102;33;135;-70,74964536;-33,50525825;1
313;222;147;45;192;-70,76490393;-33,50480393;1
314;87;69;10;79;-70,75220603;-33,50492234;1
315;85;59;0;59;-70,79685047;-33,50397322;1
316;76;50;11;61;-70,77192824;-33,5044697;1
317;175;125;0;125;-70,79168808;-33,50469152;1
318;37;23;11;34;-70,74727816;-33,50471447;1
319;93;60;5;65;-70,7971587;-33,50404884;1
320;97;70;0;70;-70,78367518;-33,50434638;1
321;53;34;0;34;-70,78604772;-33,50407467;1
322;337;240;33;273;-70,77406493;-33,50451553;1
323;39;26;0;26;-70,79218189;-33,50403963;1
324;63;46;4;50;-70,79358806;-33,50405714;1
325;82;57;0;57;-70,79746804;-33,50412907;1
326;223;138;57;195;-70,74787992;-33,50570849;1
327;163;92;54;146;-70,7451656;-33,50565487;1
328;94;64;0;64;-70,78277558;-33,50447581;1
329;84;56;16;72;-70,73831438;-33,50490524;1
330;98;62;25;87;-70,77801665;-33,50475921;1
331;85;53;6;59;-70,78322294;-33,50446698;1
332;33;26;5;31;-70,75384208;-33,5047794;1
333;74;52;13;65;-70,75306504;-33,50502837;1
334;195;127;4;131;-70,79250446;-33,50486152;1
335;57;32;13;45;-70,74513339;-33,50513485;1
336;69;47;13;60;-70,77147885;-33,50481965;1
337;28;21;0;21;-70,74042229;-33,50508477;1
338;106;80;0;80;-70,79348986;-33,50433336;1
339;65;41;0;41;-70,79215693;-33,5043209;1
340;249;143;67;210;-70,74022542;-33,50563143;1
341;48;27;11;38;-70,74339304;-33,50521622;1
342;59;43;13;56;-70,77757699;-33,50488781;1
343;89;64;12;76;-70,76939796;-33,50474894;1
344;64;34;21;55;-70,73841852;-33,50519021;1
345;85;54;6;60;-70,78142057;-33,5047796;1
346;104;69;0;69;-70,78099775;-33,50482739;1
347;161;118;0;118;-70,79398304;-33,50522701;1
348;67;46;6;52;-70,77260824;-33,50504691;1
349;112;81;0;81;-70,79338413;-33,50460488;1
350;120;83;21;104;-70,77606802;-33,50497383;1
351;50;36;0;36;-70,77449231;-33,50491047;1
352;44;30;0;30;-70,79213474;-33,5045998;1
353;37;22;8;30;-70,77714983;-33,50501563;1
354;71;41;16;57;-70,73851456;-33,50547687;1
355;43;26;11;37;-70,75073989;-33,50552736;1
356;193;138;0;138;-70,79473385;-33,50545309;1
357;102;75;0;75;-70,79329776;-33,50486937;1
358;172;112;23;135;-70,74219828;-33,50591525;1
359;191;141;4;145;-70,79508409;-33,50545527;1
360;61;41;12;53;-70,77216873;-33,50540085;1
361;109;72;14;86;-70,7763158;-33,50543603;1
362;69;47;12;59;-70,76939992;-33,50526002;1
363;28;16;0;16;-70,79209638;-33,50502442;0
364;77;53;13;66;-70,77130694;-33,50556245;1
365;228;164;5;169;-70,79535149;-33,50564611;1
366;58;35;12;47;-70,73861668;-33,5057682;1
367;153;121;0;121;-70,79567038;-33,50570315;1
368;82;61;15;76;-70,74631185;-33,50628361;1
369;250;189;14;203;-70,78527066;-33,50536006;1
370;96;68;7;75;-70,79319484;-33,50513081;1
371;449;299;12;311;-70,79738152;-33,50600221;1
372;93;53;29;82;-70,75240211;-33,50625194;1
373;153;124;11;135;-70,77029658;-33,48934571;1
374;307;188;51;239;-70,75438239;-33,50590937;1
375;78;54;22;76;-70,75609896;-33,50618016;1
376;62;32;22;54;-70,74535524;-33,50609857;1
377;151;111;18;129;-70,74042952;-33,50621458;1
378;39;30;6;36;-70,75816118;-33,50625493;1
379;81;47;24;71;-70,75947589;-33,50626157;1
380;60;41;8;49;-70,74861689;-33,5060908;1
381;100;64;14;78;-70,76094725;-33,50587408;1
382;90;51;25;76;-70,77794787;-33,50582188;1
383;88;54;17;71;-70,7763041;-33,50583848;1
384;174;120;23;143;-70,7389586;-33,50675145;1
385;201;122;51;173;-70,7628797;-33,50628776;1
386;170;116;21;137;-70,76487436;-33,50628403;1
387;78;55;11;66;-70,75164405;-33,50633829;1
388;112;80;0;80;-70,79309936;-33,50538805;1
389;18;12;4;16;-70,77193832;-33,50582087;0
390;177;108;31;139;-70,7661581;-33,50628734;1
391;140;92;33;125;-70,76686302;-33,50630459;1
392;169;117;22;139;-70,76758672;-33,50630994;1
393;113;76;17;93;-70,76834252;-33,50631778;1
394;87;62;0;62;-70,76939831;-33,50578728;1
395;326;221;38;259;-70,74299377;-33,50673769;1
396;82;58;11;69;-70,77053924;-33,50578633;1
397;129;95;8;103;-70,78961822;-33,50601183;1
398;160;118;5;123;-70,78929544;-33,50603477;1
399;142;104;7;111;-70,78994202;-33,5059954;1
400;63;43;0;43;-70,75067773;-33,50645142;1
401;169;111;15;126;-70,74251744;-33,50637791;1
402;119;92;10;102;-70,78339302;-33,50620778;1
403;122;96;0;96;-70,78897582;-33,50607803;1
404;52;44;0;44;-70,7902255;-33,50572908;1
405;142;95;15;110;-70,77520223;-33,50621052;1
406;136;99;4;103;-70,78865905;-33,50612708;1
407;51;42;0;42;-70,79055201;-33,50572947;1
408;146;114;11;125;-70,78298243;-33,50631392;1
409;68;55;0;55;-70,79584893;-33,50612039;1
410;22;15;0;15;-70,79093453;-33,50570046;0
411;61;30;23;53;-70,77748729;-33,50604143;1
412;85;58;19;77;-70,7770517;-33,5060961;1
413;32;21;8;29;-70,74555186;-33,50645307;1
414;104;84;5;89;-70,78834148;-33,50618071;1
415;58;36;17;53;-70,74460365;-33,50667151;1
416;141;110;6;116;-70,78260928;-33,50642139;1
417;127;86;13;99;-70,77656338;-33,50623987;1
418;155;126;13;139;-70,78223784;-33,50652158;1
419;266;203;10;213;-70,78804676;-33,50627713;1
420;1469;1075;87;1162;-70,74857943;-33,50836432;1
421;302;229;15;244;-70,79166546;-33,50678406;1
422;137;106;15;121;-70,78186355;-33,50661834;1
423;97;61;13;74;-70,74115957;-33,50662488;1
424;49;22;11;33;-70,74408441;-33,50679087;1
425;180;135;10;145;-70,78483797;-33,50621404;1
426;165;122;18;140;-70,78149979;-33,50673077;1
427;63;51;0;51;-70,7921618;-33,50602591;1
428;170;133;10;143;-70,7811093;-33,50681592;1
429;84;63;8;71;-70,76940035;-33,50631606;1
430;122;82;11;93;-70,78691355;-33,50623922;1
431;39;24;10;34;-70,75439204;-33,50661649;1
432;82;49;20;69;-70,77054377;-33,50631721;1
433;84;58;12;70;-70,77135252;-33,50658062;1
434;87;62;12;74;-70,76092454;-33,50662156;1
435;132;73;38;111;-70,74063649;-33,5071871;1
436;102;65;20;85;-70,77255532;-33,50631271;1
437;131;106;7;113;-70,78055818;-33,50664757;1
438;81;54;10;64;-70,77396916;-33,50632433;1
439;20;13;7;20;-70,74367624;-33,50691044;0
440;531;385;57;442;-70,77966723;-33,5072392;1
441;81;45;21;66;-70,74555522;-33,50684929;1
442;78;60;5;65;-70,79269894;-33,50636703;1
443;45;37;0;37;-70,79052082;-33,50618352;1
444;20;14;0;14;-70,79111375;-33,50634694;0
445;69;48;5;53;-70,79310219;-33,50648052;1
446;862;619;45;664;-70,78523854;-33,50791342;1
447;89;60;14;74;-70,77789686;-33,50690111;1
448;53;38;6;44;-70,7921233;-33,5064405;1
449;103;80;8;88;-70,79386605;-33,50652429;1
450;77;55;0;55;-70,77747754;-33,50697565;1
451;182;138;4;142;-70,78705428;-33,50674945;1
452;176;118;24;142;-70,76991397;-33,50684587;1
453;35;25;0;25;-70,79044515;-33,50646094;1
454;187;130;8;138;-70,77688355;-33,49677135;1
455;160;107;28;135;-70,77254779;-33,50683841;1
456;64;48;9;57;-70,77710626;-33,5070484;1
457;98;60;14;74;-70,77416726;-33,50681357;1
458;31;22;6;28;-70,75041445;-33,50727213;1
459;30;22;0;22;-70,75103607;-33,50726841;1
460;110;66;26;92;-70,7457455;-33,5073206;1
461;16;12;4;16;-70,75172315;-33,50724937;0
462;48;32;11;43;-70,75248483;-33,50737142;1
463;49;35;8;43;-70,77673427;-33,50710932;1
464;56;0;0;0;-70,75397806;-33,50868062;0
465;72;50;11;61;-70,77634934;-33,5072001;1
466;0;0;0;0;-70,78491003;-33,50691478;0
467;128;95;8;103;-70,79500548;-33,50702879;1
468;73;45;13;58;-70,77591772;-33,50723366;1
469;627;402;121;523;-70,74086356;-33,50846992;1
470;55;40;0;40;-70,79101355;-33,50671887;1
471;32;21;7;28;-70,75945086;-33,50742028;1
472;168;103;40;143;-70,7609009;-33,50744253;1
473;646;394;169;563;-70,77392416;-33,50805909;1
474;166;118;21;139;-70,76298019;-33,50748704;1
475;198;154;13;167;-70,78939372;-33,50689364;1
476;121;94;0;94;-70,79371438;-33,50689415;1
477;68;52;6;58;-70,76498819;-33,50748366;1
478;99;62;24;86;-70,7410781;-33,50769203;1
479;80;59;9;68;-70,76648553;-33,50730642;1
480;92;72;4;76;-70,7923938;-33,50713436;1
481;112;73;15;88;-70,76795144;-33,50755427;1
482;80;58;6;64;-70,7909741;-33,50699614;1
483;265;196;20;216;-70,78805714;-33,5075583;1
484;197;157;7;164;-70,79266441;-33,50758405;1
485;215;147;7;154;-70,7836703;-33,50802018;1
486;240;180;17;197;-70,78727757;-33,5074369;1
487;146;114;11;125;-70,78935127;-33,50717438;1
488;288;166;85;251;-70,74647355;-33,50788695;1
489;205;148;13;161;-70,79665966;-33,50733752;1
490;47;35;9;44;-70,75180095;-33,50798208;1
491;19;14;5;19;-70,73949136;-33,50827645;0
492;218;171;13;184;-70,79392457;-33,50735479;1
493;117;85;11;96;-70,78081933;-33,50770333;1
494;297;214;18;232;-70,78485418;-33,50739246;1
495;205;133;42;175;-70,75116092;-33,50923992;1
496;69;56;0;56;-70,79094948;-33,50726822;1
497;58;36;12;48;-70,75049834;-33,50805569;1
498;50;37;0;37;-70,7664773;-33,50774632;1
499;160;128;6;134;-70,78934108;-33,50744543;1
500;215;153;19;172;-70,77682842;-33,50777583;1
501;53;40;8;48;-70,75257669;-33,508406;1
502;148;108;16;124;-70,78262097;-33,5077605;1
503;161;122;13;135;-70,79378606;-33,5076891;1
504;37;22;11;33;-70,74393865;-33,50836139;1
505;60;39;14;53;-70,74300717;-33,5084008;1
506;88;63;0;63;-70,7909542;-33,5075399;1
507;57;39;10;49;-70,75810382;-33,5084061;1
508;236;175;14;189;-70,79655679;-33,50772732;1
509;115;81;18;99;-70,76043083;-33,50846261;1
510;55;27;17;44;-70,74542067;-33,50854235;1
511;638;443;35;478;-70,79865776;-33,51272482;1
512;113;80;8;88;-70,79485319;-33,50781244;1
513;155;118;8;126;-70,78934906;-33,50771797;1
514;52;31;12;43;-70,74633459;-33,50858734;1
515;116;75;30;105;-70,76512956;-33,5084959;1
516;154;109;13;122;-70,77779603;-33,50834457;1
517;113;80;0;80;-70,79526177;-33,50792967;1
518;295;228;13;241;-70,78689041;-33,50803358;1
519;92;55;27;82;-70,76645313;-33,50883756;1
520;146;108;14;122;-70,78138043;-33,50827005;1
521;161;115;15;130;-70,77734085;-33,50846525;1
522;207;155;9;164;-70,79365405;-33,50802756;1
523;96;64;15;79;-70,76813227;-33,50860602;1
524;100;55;23;78;-70,78300244;-33,50836139;1
525;11;9;0;9;-70,79775131;-33,50786296;0
526;174;134;19;153;-70,77639453;-33,50824926;1
527;239;180;18;198;-70,79642105;-33,50805256;1
528;61;40;0;40;-70,78264296;-33,50841207;1
529;94;55;32;87;-70,75190577;-33,50905787;1
530;34;24;0;24;-70,75054527;-33,50871759;1
531;75;48;15;63;-70,74977023;-33,50875529;1
532;53;42;0;42;-70,79146549;-33,50810475;1
533;246;173;19;192;-70,79133274;-33,50838441;1
534;183;149;7;156;-70,7894197;-33,50824023;1
535;225;169;12;181;-70,79350959;-33,50838736;1
536;92;74;6;80;-70,79786205;-33,50820469;1
537;133;100;14;114;-70,74204277;-33,50952937;1
538;384;226;95;321;-70,74473627;-33,50915796;1
539;142;110;7;117;-70,78502247;-33,5083513;1
540;220;174;8;182;-70,79629366;-33,50838064;1
541;140;93;21;114;-70,7764325;-33,50860344;1
542;98;66;17;83;-70,77997288;-33,50870376;1
543;205;154;18;172;-70,78737003;-33,5084721;1
544;57;38;12;50;-70,74258101;-33,50925169;1
545;94;60;12;72;-70,74051586;-33,50954765;1
546;128;93;10;103;-70,78134886;-33,50880615;1
547;149;100;13;113;-70,7979109;-33,50856677;1
548;145;109;14;123;-70,78532394;-33,50869246;1
549;115;80;9;89;-70,78923377;-33,50864391;1
550;42;26;0;26;-70,75060159;-33,50925608;1
551;99;72;17;89;-70,75286354;-33,50966143;1
552;45;31;8;39;-70,74987958;-33,50928963;1
553;99;71;5;76;-70,78796642;-33,50877896;1
554;0;0;0;0;-70,79279262;-33,50878303;0
555;0;0;0;0;-70,7581245;-33,50982617;0
556;96;71;7;78;-70,78684985;-33,50889903;1
557;112;89;5;94;-70,79629945;-33,50896851;1
558;139;98;20;118;-70,77994625;-33,50920814;1
559;12;8;0;8;-70,76256988;-33,50985656;0
560;75;43;22;65;-70,770934;-33,50948864;1
561;66;48;5;53;-70,7935367;-33,50895193;1
562;124;82;27;109;-70,76953484;-33,50980274;1
563;109;81;0;81;-70,7972017;-33,50909713;1
564;151;109;12;121;-70,78538144;-33,50904569;1
565;161;118;4;122;-70,79079149;-33,50928529;1
566;32;19;9;28;-70,77140617;-33,50931249;1
567;160;106;17;123;-70,78133389;-33,50926077;1
568;59;44;7;51;-70,78222349;-33,50931646;1
569;119;85;9;94;-70,78366715;-33,50907082;1
570;82;66;7;73;-70,78980174;-33,50899505;1
571;107;86;0;86;-70,79670477;-33,50908472;1
572;18;13;0;13;-70,76527178;-33,50946253;0
573;75;52;0;52;-70,7825989;-33,50932551;1
574;392;301;15;316;-70,79133353;-33,50928209;1
575;30;17;9;26;-70,77191798;-33,50934741;1
576;192;136;8;144;-70,78331053;-33,50955784;1
577;116;94;4;98;-70,7938593;-33,50922807;1
578;97;74;7;81;-70,79257778;-33,50936606;1
579;117;81;14;95;-70,74472412;-33,50997786;1
580;103;80;5;85;-70,79811327;-33,50900227;1
581;110;76;22;98;-70,72480885;-33,50975308;1
582;100;74;11;85;-70,78867777;-33,50910991;1
583;62;40;13;53;-70,77273329;-33,50958668;1
584;72;47;7;54;-70,77761303;-33,50948495;1
585;50;37;0;37;-70,79298458;-33,50909547;1
586;151;94;40;134;-70,76765512;-33,50998273;1
587;160;123;4;127;-70,79421683;-33,50940703;1
588;18;0;0;0;-70,77712707;-33,50955671;0
589;0;0;0;0;-70,78786215;-33,50942994;0
590;39;32;0;32;-70,77391157;-33,50966678;1
591;96;66;10;76;-70,72784415;-33,51021224;1
592;79;54;6;60;-70,78737566;-33,50948191;1
593;159;114;10;124;-70,79463167;-33,50952222;1
594;58;40;11;51;-70,77452163;-33,50970501;1
595;40;30;7;37;-70,77672658;-33,50959336;1
596;84;56;9;65;-70,786985;-33,50952778;1
597;26;15;8;23;-70,77516574;-33,50973956;1
598;101;72;7;79;-70,78659522;-33,50956734;1
599;91;58;23;81;-70,72943006;-33,51051604;1
600;138;103;12;115;-70,77993611;-33,50966142;1
601;153;119;6;125;-70,79804538;-33,50933505;1
602;87;62;4;66;-70,78984876;-33,50933291;1
603;63;46;0;46;-70,77606137;-33,50962813;1
604;148;111;14;125;-70,7854332;-33,50946737;1
605;211;160;10;170;-70,79585199;-33,50947481;1
606;82;65;4;69;-70,78131535;-33,50970636;1
607;43;34;4;38;-70,79317663;-33,50941357;1
608;71;50;5;55;-70,78872597;-33,50962257;1
609;82;54;20;74;-70,73021705;-33,51080581;1
610;110;71;14;85;-70,82513607;-33,50949274;1
611;106;71;22;93;-70,7310045;-33,51072662;1
612;99;66;24;90;-70,73173066;-33,51071277;1
613;80;42;21;63;-70,73238208;-33,51067418;1
614;91;57;23;80;-70,73302842;-33,5106551;1
615;24;11;0;11;-70,77181326;-33,5098176;0
616;94;69;11;80;-70,82591515;-33,50952712;1
617;108;78;10;88;-70,73370118;-33,51061452;1
618;27;16;8;24;-70,77228062;-33,50984519;1
619;84;56;8;64;-70,78416015;-33,50986887;1
620;112;80;16;96;-70,72905464;-33,51096824;1
621;20;16;0;16;-70,72337497;-33,51138629;0
622;102;71;17;88;-70,73523711;-33,51058208;1
623;138;106;4;110;-70,7979868;-33,50967655;1
624;92;64;16;80;-70,73648284;-33,51052718;1
625;219;166;9;175;-70,79571899;-33,50980244;1
626;101;66;16;82;-70,82671017;-33,50972356;1
627;154;114;12;126;-70,78549987;-33,50982157;1
628;225;177;8;185;-70,79380889;-33,51023719;1
629;50;34;0;34;-70,72761353;-33,51076134;1
630;91;59;11;70;-70,8242849;-33,5096195;1
631;131;98;10;108;-70,77991217;-33,51010496;1
632;101;60;14;74;-70,82748985;-33,50976879;1
633;197;133;26;159;-70,77675517;-33,51006953;1
634;778;572;38;610;-70,78260646;-33,51033419;1
635;154;117;12;129;-70,78130637;-33,51017745;1
636;118;82;7;89;-70,79679185;-33,51010677;1
637;163;116;32;148;-70,76960718;-33,5108397;1
638;239;144;58;202;-70,7716732;-33,51076474;1
639;104;78;0;78;-70,79083997;-33,5103504;1
640;126;99;0;99;-70,79717966;-33,51021414;1
641;101;69;8;77;-70,78788223;-33,51003361;1
642;175;132;12;144;-70,78989246;-33,51004367;1
643;76;41;22;63;-70,77263936;-33,51073155;1
644;126;87;5;92;-70,79125539;-33,51038372;1
645;123;90;9;99;-70,79165232;-33,51041683;1
646;658;492;39;531;-70,79545468;-33,51072093;1
647;187;135;7;142;-70,78554399;-33,51016074;1
648;171;114;12;126;-70,7870084;-33,51012808;1
649;54;34;16;50;-70,77326864;-33,51053941;1
650;98;69;6;75;-70,78366688;-33,51032979;1
651;96;74;5;79;-70,79205489;-33,51045574;1
652;128;96;6;102;-70,79807714;-33,51012378;1
653;32;21;5;26;-70,77403781;-33,51040892;1
654;62;0;0;0;-70,72852256;-33,51128571;0
655;190;121;11;132;-70,78881562;-33,51015739;1
656;128;79;23;102;-70,76863675;-33,5111634;1
657;108;80;4;84;-70,79246042;-33,51049447;1
658;167;120;16;136;-70,77474441;-33,51103903;1
659;52;39;5;44;-70,77522701;-33,51150124;1
660;44;33;0;33;-70,7929606;-33,5101534;1
661;105;70;18;88;-70,74112088;-33,51096621;1
662;136;98;9;107;-70,78427102;-33,51048001;1
663;147;106;15;121;-70,77989785;-33,5105842;1
664;93;59;20;79;-70,74202747;-33,51123972;1
665;54;31;17;48;-70,77056645;-33,51058668;1
666;64;48;11;59;-70,77737778;-33,51047678;1
667;137;101;13;114;-70,78129561;-33,51060571;1
668;457;299;69;368;-70,74284664;-33,51326886;1
669;284;191;21;212;-70,78741523;-33,51045446;1
670;70;37;19;56;-70,74346653;-33,51155234;1
671;176;115;15;130;-70,7899353;-33,51040978;1
672;71;48;6;54;-70,78614177;-33,51045092;1
673;316;203;66;269;-70,74405028;-33,51217375;1
674;61;40;15;55;-70,74449587;-33,51145454;1
675;170;106;13;119;-70,78524391;-33,51055052;1
676;144;107;7;114;-70,79798705;-33,51046749;1
677;191;132;10;142;-70,78886855;-33,51052228;1
678;46;27;16;43;-70,76074923;-33,51125242;1
679;248;150;63;213;-70,74523281;-33,51218066;1
680;195;132;42;174;-70,75392893;-33,51157073;1
681;93;71;4;75;-70,79287625;-33,51070306;1
682;98;69;6;75;-70,78310305;-33,51077623;1
683;304;215;64;279;-70,75103405;-33,51235434;1
684;307;188;73;261;-70,74632348;-33,51230282;1
685;82;59;0;59;-70,79327632;-33,5107442;1
686;22;13;6;19;-70,74682194;-33,51126884;0
687;96;66;5;71;-70,78374945;-33,51073675;1
688;21;18;0;18;-70,77400377;-33,51093494;0
689;83;58;4;62;-70,77742126;-33,51081991;1
690;78;62;0;62;-70,72581219;-33,48046637;1
691;60;42;8;50;-70,73764248;-33,47321597;1
692;84;56;12;68;-70,73266138;-33,48047653;1
693;94;71;11;82;-70,74078799;-33,48039479;1
694;74;58;4;62;-70,74984772;-33,4801016;1
695;77;61;7;68;-70,73835792;-33,4802623;1
696;62;47;6;53;-70,72459335;-33,48051865;1
697;78;61;4;65;-70,72697646;-33,48061615;1
698;69;52;11;63;-70,74344188;-33,48056617;1
699;111;75;13;88;-70,72815136;-33,48064133;1
700;38;28;4;32;-70,73510004;-33,480359;1
701;110;84;12;96;-70,72985778;-33,48065878;1
702;93;67;10;77;-70,73288375;-33,48078538;1
703;106;87;4;91;-70,74955347;-33,48038403;1
704;65;51;0;51;-70,72610743;-33,48070153;1
705;18;0;0;0;-70,73549264;-33,48053473;0
706;67;45;10;55;-70,72488514;-33,48076373;1
707;102;79;10;89;-70,73997044;-33,48082679;1
708;51;40;0;40;-70,73727862;-33,48066965;1
709;98;66;10;76;-70,72844149;-33,48088775;1
710;140;107;6;113;-70,74926852;-33,48065631;1
711;99;78;6;84;-70,74159838;-33,48084135;1
712;99;78;12;90;-70,73320574;-33,48100039;1
713;52;35;4;39;-70,73186972;-33,480601;1
714;105;74;16;90;-70,73508478;-33,48089119;1
715;45;36;0;36;-70,73588825;-33,48072158;1
716;83;60;9;69;-70,72639411;-33,48093828;1
717;104;86;8;94;-70,74255911;-33,48105658;1
718;75;54;7;61;-70,72516702;-33,48100272;1
719;151;119;10;129;-70,7489844;-33,48092852;1
720;89;68;12;80;-70,74197807;-33,48105675;1
721;81;57;14;71;-70,72872191;-33,48112565;1
722;82;68;9;77;-70,74040481;-33,48108107;1
723;90;65;0;65;-70,73041475;-33,48112826;1
724;87;56;26;82;-70,750446;-33,49664141;1
725;94;71;13;84;-70,73428625;-33,47350504;1
726;117;85;7;92;-70,73355319;-33,4811983;1
727;49;37;0;37;-70,72691924;-33,48106131;1
728;69;43;13;56;-70,73720864;-33,48103973;1
729;53;31;12;43;-70,75359015;-33,48961144;1
730;50;32;8;40;-70,73192566;-33,48093211;1
731;214;161;19;180;-70,74739507;-33,48194273;1
732;72;52;11;63;-70,7254501;-33,4812402;1
733;91;68;9;77;-70,74289536;-33,4813339;1
734;84;57;17;74;-70,73857913;-33,48112497;1
735;74;54;7;61;-70,72741601;-33,4812522;1
736;71;53;4;57;-70,75835734;-33,48070628;1
737;36;27;5;32;-70,73621619;-33,48105298;1
738;117;85;8;93;-70,73381784;-33,48140587;1
739;97;76;9;85;-70,7290037;-33,4813564;1
740;112;86;0;86;-70,75987233;-33,48098545;1
741;77;51;11;62;-70,73066624;-33,48140066;1
742;141;105;13;118;-70,73408368;-33,48158559;1
743;44;23;0;23;-70,74404407;-33,4813365;1
744;94;82;5;87;-70,73703376;-33,48137863;1
745;1767;1317;103;1420;-70,75507163;-33,48280767;1
746;47;31;0;31;-70,72776627;-33,48145236;1
747;71;53;4;57;-70,73198039;-33,48126241;1
748;94;61;16;77;-70,72926103;-33,48161969;1
749;58;39;10;49;-70,73594005;-33,48137043;1
750;105;77;7;84;-70,74113355;-33,48148082;1
751;77;52;9;61;-70,73835546;-33,48144582;1
752;151;111;11;122;-70,73435447;-33,48176212;1
753;87;55;0;55;-70,76258293;-33,48104797;1
754;54;39;0;39;-70,72829731;-33,48176963;1
755;103;75;17;92;-70,73982197;-33,48168606;1
756;61;44;5;49;-70,72964475;-33,48174924;1
757;138;101;7;108;-70,73466583;-33,4819176;1
758;114;89;10;99;-70,73686108;-33,4817261;1
759;82;64;8;72;-70,74089369;-33,48179315;1
760;36;21;11;32;-70,74334033;-33,48161752;1
761;77;54;7;61;-70,73813013;-33,48176484;1
762;127;90;11;101;-70,73498399;-33,4820808;1
763;141;107;0;107;-70,76126342;-33,48180939;1
764;74;60;0;60;-70,74865956;-33,48177756;1
765;94;69;9;78;-70,73957608;-33,48199259;1
766;60;44;8;52;-70,74422568;-33,48207659;1
767;45;31;10;41;-70,743692;-33,48201073;1
768;160;114;16;130;-70,7352775;-33,48225247;1
769;84;57;13;70;-70,74228859;-33,48196619;1
770;31;21;4;25;-70,74309773;-33,4819376;1
771;181;140;13;153;-70,73556787;-33,4824138;1
772;67;47;8;55;-70,73788838;-33,4820856;1
773;120;92;0;92;-70,76063741;-33,48196016;1
774;66;47;8;55;-70,73881784;-33,48224299;1
775;71;55;7;62;-70,74203913;-33,48227428;1
776;91;64;11;75;-70,7403682;-33,48243985;1
777;173;130;11;141;-70,73618769;-33,48271457;1
778;71;55;8;63;-70,74456777;-33,48253236;1
779;35;25;0;25;-70,76011914;-33,48213628;1
780;62;48;7;55;-70,74077617;-33,4825954;1
781;166;133;9;142;-70,73651793;-33,48283156;1
782;81;53;16;69;-70,74271694;-33,4826544;1
783;77;56;10;66;-70,74126033;-33,48270148;1
784;154;112;9;121;-70,73686939;-33,48293575;1
785;68;53;11;64;-70,74311597;-33,4828205;1
786;149;113;12;125;-70,73731804;-33,48302402;1
787;67;57;4;61;-70,74165881;-33,48286261;1
788;39;23;14;37;-70,7451284;-33,48290492;1
789;53;39;8;47;-70,74352497;-33,48299093;1
790;50;36;0;36;-70,74840859;-33,48275841;1
791;258;190;26;216;-70,75797707;-33,48406292;1
792;15;11;0;11;-70,74555469;-33,48474791;0
793;62;49;0;49;-70,74765872;-33,4830528;1
794;115;88;10;98;-70,74492483;-33,48349258;1
795;69;45;0;45;-70,76466274;-33,48278796;1
796;55;40;0;40;-70,76595948;-33,48283382;1
797;77;55;9;64;-70,74383049;-33,48345631;1
798;106;81;8;89;-70,7425079;-33,48339432;1
799;74;54;13;67;-70,74852575;-33,48332033;1
800;52;37;6;43;-70,75765063;-33,48350438;1
801;21;17;0;17;-70,74443888;-33,48353795;0
802;90;60;23;83;-70,74746374;-33,4841412;1
803;55;39;8;47;-70,74556362;-33,48359179;1
804;40;22;13;35;-70,74778064;-33,48364157;1
805;38;31;0;31;-70,74913009;-33,48360785;1
806;66;42;0;42;-70,76570891;-33,48323775;1
807;190;147;20;167;-70,75561169;-33,48472052;1
808;68;46;14;60;-70,74839072;-33,48392859;1
809;324;242;31;273;-70,75467851;-33,48496329;1
810;69;50;10;60;-70,74442657;-33,48398592;1
811;92;65;6;71;-70,77056496;-33,48402358;1
812;102;71;4;75;-70,76697174;-33,48370503;1
813;96;64;6;70;-70,77007548;-33,48394877;1
814;69;44;11;55;-70,74925774;-33,48417403;1
815;102;73;8;81;-70,76968709;-33,48407164;1
816;115;73;6;79;-70,76744008;-33,48394642;1
817;499;355;28;383;-70,73605599;-33,48480908;1
818;104;68;13;81;-70,76929341;-33,48418711;1
819;105;80;0;80;-70,76406154;-33,48407803;1
820;103;81;16;97;-70,75662377;-33,484745;1
821;80;58;11;69;-70,76617873;-33,48414827;1
822;140;102;4;106;-70,76802933;-33,48415889;1
823;27;15;0;15;-70,74853043;-33,48448518;0
824;98;70;8;78;-70,76251196;-33,48425553;1
825;63;44;0;44;-70,7644526;-33,48423758;1
826;106;77;4;81;-70,76202003;-33,48430442;1
827;32;22;0;22;-70,74988165;-33,48449685;1
828;106;83;0;83;-70,76158203;-33,48433947;1
829;99;72;5;77;-70,76114305;-33,48437476;1
830;93;70;4;74;-70,76004167;-33,48439689;1
831;80;52;0;52;-70,76480219;-33,48444001;1
832;66;47;9;56;-70,7491807;-33,48479992;1
833;116;85;11;96;-70,76832647;-33,48446399;1
834;142;110;15;125;-70,75702414;-33,48549048;1
835;101;76;5;81;-70,76356038;-33,484685;1
836;93;68;0;68;-70,76514909;-33,48463903;1
837;129;90;10;100;-70,76743827;-33,48487144;1
838;306;238;22;260;-70,76090062;-33,48556578;1
839;114;70;12;82;-70,77150439;-33,48468963;1
840;51;36;7;43;-70,75374965;-33,48494635;1
841;161;121;13;134;-70,75766812;-33,48583181;1
842;47;32;9;41;-70,75002144;-33,48502643;1
843;87;66;11;77;-70,76860713;-33,48476211;1
844;102;82;0;82;-70,76389001;-33,4849151;1
845;106;79;0;79;-70,76545708;-33,48489567;1
846;62;46;0;46;-70,76214165;-33,48481757;1
847;454;328;52;380;-70,75411007;-33,48645873;1
848;74;54;0;54;-70,76097408;-33,48489607;1
849;98;68;10;78;-70,74884627;-33,48558115;1
850;153;108;13;121;-70,7583364;-33,48619057;1
851;32;24;4;28;-70,74932968;-33,485317;1
852;98;65;19;84;-70,75010359;-33,48545678;1
853;98;81;0;81;-70,76423515;-33,48512317;1
854;206;145;15;160;-70,76560309;-33,48543372;1
855;230;158;6;164;-70,73838131;-33,48550249;1
856;224;159;11;170;-70,73728669;-33,48554523;1
857;223;157;7;164;-70,7731405;-33,4850504;1
858;365;262;17;279;-70,73656622;-33,48560025;1
859;352;254;23;277;-70,73587085;-33,4856186;1
860;354;252;17;269;-70,73508151;-33,485644;1
861;374;267;15;282;-70,7343511;-33,48565138;1
862;181;132;13;145;-70,76989298;-33,48527017;1
863;139;98;0;98;-70,76353603;-33,4854109;1
864;92;71;5;76;-70,76458643;-33,48532086;1
865;107;89;5;94;-70,76191645;-33,48523674;1
866;53;40;9;49;-70,75349579;-33,48550882;1
867;200;158;10;168;-70,76598988;-33,48565585;1
868;877;606;35;641;-70,74084532;-33,48644821;1
869;595;417;23;440;-70,74662041;-33,49120637;1
870;55;39;0;39;-70,75948798;-33,48564611;1
871;109;83;6;89;-70,76495369;-33,48550108;1
872;90;64;17;81;-70,75526627;-33,48576162;1
873;131;97;0;97;-70,76335014;-33,48576116;1
874;88;68;0;68;-70,73810196;-33,48645619;1
875;115;77;8;85;-70,77313398;-33,48545293;1
876;161;124;4;128;-70,76726971;-33,48575829;1
877;86;59;6;65;-70,7322842;-33,48607547;1
878;102;74;4;78;-70,7701019;-33,48552269;1
879;78;59;0;59;-70,73264895;-33,48604034;1
880;79;60;0;60;-70,73308685;-33,48601273;1
881;56;45;0;45;-70,7602266;-33,4858349;1
882;167;119;10;129;-70,77242737;-33,48592193;1
883;78;59;5;64;-70,76240415;-33,48573607;1
884;56;41;7;48;-70,75437798;-33,48597871;1
885;131;91;7;98;-70,76921978;-33,48590608;1
886;139;98;8;106;-70,77045297;-33,48572618;1
887;96;66;12;78;-70,77356406;-33,48568859;1
888;34;31;0;31;-70,7399045;-33,48615413;1
889;86;63;0;63;-70,73901143;-33,48608286;1
890;93;72;0;72;-70,76640973;-33,48589977;1
891;85;57;7;64;-70,73672314;-33,48615459;1
892;290;214;31;245;-70,75237043;-33,48679747;1
893;43;30;0;30;-70,73584387;-33,48627473;1
894;601;446;54;500;-70,75994613;-33,48695363;1
895;27;19;0;19;-70,73543243;-33,48629007;0
896;69;58;4;62;-70,7345982;-33,48621636;1
897;111;84;5;89;-70,76456885;-33,48601692;1
898;0;0;0;0;-70,76303154;-33,48607774;0
899;121;94;6;100;-70,73384541;-33,4868886;1
900;130;92;0;92;-70,77399373;-33,48590955;1
901;106;73;6;79;-70,73768125;-33,48679686;1
902;124;88;9;97;-70,77088868;-33,48597542;1
903;94;70;8;78;-70,73279546;-33,4864749;1
904;91;72;0;72;-70,76676615;-33,48610844;1
905;92;60;4;64;-70,73898994;-33,48684245;1
906;79;57;0;57;-70,73857289;-33,48685595;1
907;79;53;0;53;-70,73723263;-33,48690078;1
908;102;69;4;73;-70,73681827;-33,4869076;1
909;57;40;8;48;-70,75525403;-33,48645414;1
910;113;87;6;93;-70,76438055;-33,48636808;1
911;162;116;6;122;-70,77442896;-33,48613116;1
912;56;40;0;40;-70,73465394;-33,48655821;1
913;80;69;0;69;-70,76710985;-33,48630758;1
914;96;64;9;73;-70,77135092;-33,48623389;1
915;62;45;0;45;-70,76340253;-33,48633643;1
916;58;46;5;51;-70,73317419;-33,48670717;1
917;174;135;12;147;-70,76862643;-33,48655272;1
918;50;40;0;40;-70,73965928;-33,48658639;1
919;50;33;8;41;-70,75311615;-33,4866358;1
920;69;49;14;63;-70,75631549;-33,48673963;1
921;164;129;11;140;-70,76654847;-33,48662328;1
922;68;57;0;57;-70,7359187;-33,48670639;1
923;147;104;4;108;-70,77610831;-33,48646736;1
924;106;76;8;84;-70,770411;-33,48658669;1
925;65;48;0;48;-70,76769345;-33,48645653;1
926;107;87;0;87;-70,73283718;-33,48722453;1
927;33;24;0;24;-70,76377967;-33,48655078;1
928;118;82;0;82;-70,77179909;-33,48647639;1
929;54;45;0;45;-70,75343658;-33,48685394;1
930;105;67;5;72;-70,77458987;-33,48641202;1
931;73;47;0;47;-70,73471297;-33,48689798;1
932;88;62;13;75;-70,75676161;-33,48697811;1
933;43;32;0;32;-70,73330589;-33,48699536;1
934;389;300;25;325;-70,76334388;-33,48701947;1
935;57;48;0;48;-70,73967833;-33,4869155;1
936;32;25;0;25;-70,76423622;-33,48674066;1
937;59;35;14;49;-70,7537853;-33,48703047;1
938;80;49;7;56;-70,73593219;-33,48703058;1
939;103;67;9;76;-70,77503037;-33,48662006;1
940;269;192;18;210;-70,74316137;-33,48771993;1
941;158;113;4;117;-70,77199404;-33,48681903;1
942;84;68;0;68;-70,76806584;-33,48686598;1
943;75;49;17;66;-70,75720864;-33,48718436;1
944;67;52;0;52;-70,75413851;-33,48720837;1
945;51;38;0;38;-70,73343417;-33,48728397;1
946;37;27;0;27;-70,73502229;-33,48730527;1
947;37;26;0;26;-70,77434627;-33,48697947;1
948;37;26;0;26;-70,73457377;-33,48730937;1
949;135;101;6;107;-70,76632449;-33,48704222;1
950;94;68;0;68;-70,77542427;-33,48682894;1
951;60;43;0;43;-70,75229613;-33,48737289;1
952;62;50;0;50;-70,73968915;-33,48724933;1
953;95;73;5;78;-70,76840611;-33,48706461;1
954;125;81;7;88;-70,77269938;-33,4869729;1
955;66;46;5;51;-70,73594944;-33,48735784;1
956;72;40;24;64;-70,75794042;-33,4874168;1
957;135;86;13;99;-70,73181392;-33,48783661;1
958;97;62;10;72;-70,73223572;-33,48793057;1
959;47;36;6;42;-70,7548421;-33,48734903;1
960;159;122;5;127;-70,76599461;-33,48730992;1
961;157;120;5;125;-70,76995722;-33,48732274;1
962;161;125;5;130;-70,76790744;-33,48741868;1
963;99;73;4;77;-70,77582479;-33,48704737;1
964;32;25;0;25;-70,73356654;-33,48757464;1
965;95;77;0;77;-70,76875888;-33,48727302;1
966;531;346;26;372;-70,74130018;-33,48881887;1
967;90;62;19;81;-70,75613877;-33,48754916;1
968;102;70;0;70;-70,77308171;-33,48719529;1
969;331;243;16;259;-70,77640794;-33,48754705;1
970;52;36;5;41;-70,73970305;-33,48761795;1
971;81;61;6;67;-70,73903378;-33,48796517;1
972;74;58;9;67;-70,73861931;-33,48797911;1
973;627;431;31;462;-70,74397504;-33,48880145;1
974;81;60;5;65;-70,73794793;-33,48799868;1
975;81;60;0;60;-70,73727153;-33,48801533;1
976;71;60;0;60;-70,73685929;-33,48802754;1
977;65;43;0;43;-70,73645128;-33,4880388;1
978;112;89;15;104;-70,7353429;-33,48774102;1
979;45;36;0;36;-70,76590115;-33,48765112;1
980;13;0;0;0;-70,75977062;-33,4874138;0
981;65;47;4;51;-70,77781216;-33,48731701;1
982;143;95;15;110;-70,77346909;-33,48739193;1
983;95;74;0;74;-70,76917708;-33,48750476;1
984;55;36;12;48;-70,75463449;-33,48767536;1
985;28;0;0;0;-70,76020661;-33,48754071;0
986;94;77;0;77;-70,73424477;-33,48818151;1
987;131;91;9;100;-70,76542672;-33,48771458;1
988;106;82;0;82;-70,76730336;-33,48760873;1
989;107;81;7;88;-70,77220337;-33,48760343;1
990;45;36;0;36;-70,76107673;-33,4876245;1
991;56;36;8;44;-70,76197495;-33,48764669;1
992;32;23;4;27;-70,73377456;-33,48794281;1
993;21;14;0;14;-70,75532225;-33,48780727;0
994;372;278;36;314;-70,75886546;-33,48784192;1
995;45;30;7;37;-70,76341422;-33,48769402;1
996;96;69;8;77;-70,73363831;-33,48824504;1
997;62;44;0;44;-70,76431084;-33,48772583;1
998;99;75;9;84;-70,7695573;-33,48772555;1
999;120;88;8;96;-70,77387326;-33,48761135;1
1000;51;37;6;43;-70,73971897;-33,48794844;1
1001;59;45;0;45;-70,7414264;-33,48815726;1
1002;39;27;0;27;-70,75982932;-33,48785704;1
1003;77;49;12;61;-70,75296972;-33,48802485;1
1004;107;83;8;91;-70,73540743;-33,4880702;1
1005;104;79;12;91;-70,75460526;-33,48809138;1
1006;170;129;17;146;-70,7672383;-33,4880354;1
1007;117;86;14;100;-70,75257567;-33,48849376;1
1008;53;42;4;46;-70,75573942;-33,48801495;1
1009;147;116;7;123;-70,77121503;-33,48803415;1
1010;81;59;0;59;-70,77791238;-33,48781544;1
1011;116;90;4;94;-70,76992464;-33,48794543;1
1012;78;63;0;63;-70,75336181;-33,48836727;1
1013;276;217;12;229;-70,77449651;-33,48836688;1
1014;119;88;11;99;-70,74343872;-33,48874054;1
1015;47;37;5;42;-70,75612844;-33,48818986;1
1016;148;117;5;122;-70,76922529;-33,48818105;1
1017;65;49;0;49;-70,73973218;-33,48827435;1
1018;151;97;14;111;-70,78442081;-33,49500235;1
1019;74;53;12;65;-70,73546361;-33,48839641;1
1020;215;174;6;180;-70,76699914;-33,48833577;1
1021;126;91;8;99;-70,74288434;-33,48938874;1
1022;38;29;0;29;-70,75650827;-33,48836946;1
1023;76;53;14;67;-70,75376299;-33,48863365;1
1024;62;46;6;52;-70,76043324;-33,48854699;1
1025;85;54;6;60;-70,73227331;-33,48880075;1
1026;86;56;6;62;-70,73184138;-33,48880885;1
1027;40;29;0;29;-70,76151637;-33,48826317;1
1028;60;44;5;49;-70,76196587;-33,48839461;1
1029;274;204;15;219;-70,78014903;-33,4885589;1
1030;57;49;0;49;-70,76240315;-33,48847508;1
1031;101;79;0;79;-70,77052292;-33,48829597;1
1032;46;35;0;35;-70,76292716;-33,48852526;1
1033;83;61;0;61;-70,75999538;-33,48865682;1
1034;64;45;8;53;-70,76337679;-33,48855279;1
1035;104;72;8;80;-70,76382378;-33,48858441;1
1036;86;65;6;71;-70,76427035;-33,48862141;1
1037;124;86;0;86;-70,77654308;-33,4882598;1
1038;106;77;10;87;-70,75581596;-33,48864661;1
1039;77;56;14;70;-70,75411099;-33,48887091;1
1040;66;46;9;55;-70,76471898;-33,48864931;1
1041;36;31;0;31;-70,75689014;-33,4885483;1
1042;56;44;5;49;-70,75954377;-33,48859617;1
1043;106;83;9;92;-70,76516779;-33,48869747;1
1044;40;35;0;35;-70,76089415;-33,48862971;1
1045;65;49;0;49;-70,73974296;-33,48864033;1
1046;239;185;13;198;-70,76661584;-33,48898518;1
1047;77;60;0;60;-70,76695349;-33,48873161;1
1048;75;55;9;64;-70,76559638;-33,48885144;1
1049;115;87;8;95;-70,73908086;-33,48908181;1
1050;105;82;6;88;-70,73866741;-33,48909433;1
1051;117;83;15;98;-70,738213;-33,48927498;1
1052;111;83;12;95;-70,73779652;-33,48928835;1
1053;98;82;0;82;-70,73732139;-33,48913401;1
1054;50;35;0;35;-70,75899094;-33,4885064;1
1055;86;61;11;72;-70,73690679;-33,48914447;1
1056;75;51;0;51;-70,73649198;-33,48906469;1
1057;82;57;13;70;-70,73552488;-33,4887654;1
1058;108;85;6;91;-70,77088917;-33,488512;1
1059;101;78;13;91;-70,74220799;-33,4895665;1
1060;106;82;9;91;-70,75448362;-33,48909093;1
1061;39;28;0;28;-70,75728098;-33,48872234;1
1062;206;154;15;169;-70,77833083;-33,48908761;1
1063;109;83;11;94;-70,75898766;-33,48889196;1
1064;206;162;11;173;-70,77266852;-33,48882755;1
1065;162;113;8;121;-70,73312526;-33,48960631;1
1066;11;9;0;9;-70,76143341;-33,4887502;0
1067;179;135;14;149;-70,76860537;-33,48883314;1
1068;131;88;4;92;-70,73351869;-33,48968003;1
1069;97;74;8;82;-70,76913525;-33,48867885;1
1070;57;40;0;40;-70,75767165;-33,48890169;1
1071;54;42;0;42;-70,73976062;-33,48896656;1
1072;99;83;0;83;-70,77125994;-33,48872912;1
1073;144;113;6;119;-70,77046686;-33,48891278;1
1074;88;69;10;79;-70,75493244;-33,48928939;1
1075;89;68;0;68;-70,73557673;-33,48908893;1
1076;56;39;0;39;-70,77533251;-33,48863362;1
1077;140;117;5;122;-70,74178398;-33,48982686;1
1078;90;63;10;73;-70,76603428;-33,48913682;1
1079;48;32;9;41;-70,75805419;-33,48908054;1
1080;84;57;15;72;-70,75715032;-33,48925198;1
1081;203;155;5;160;-70,77922658;-33,48888985;1
1082;123;103;0;103;-70,76819258;-33,48903939;1
1083;79;58;12;70;-70,75532739;-33,48947396;1
1084;68;55;0;55;-70,77186773;-33,48884628;1
1085;143;98;6;104;-70,7327049;-33,48975858;1
1086;171;133;12;145;-70,74139456;-33,49003839;1
1087;112;87;4;91;-70,73229353;-33,48977318;1
1088;61;47;0;47;-70,73977255;-33,48929189;1
1089;115;90;5;95;-70,73186516;-33,48977944;1
1090;48;35;0;35;-70,7584311;-33,4892336;1
1091;76;55;5;60;-70,73563595;-33,4894152;1
1092;101;73;4;77;-70,77637711;-33,48899152;1
1093;91;72;7;79;-70,75571807;-33,48965413;1
1094;84;65;6;71;-70,74654504;-33,47280334;1
1095;123;99;7;106;-70,74096736;-33,49002119;1
1096;90;65;4;69;-70,73512353;-33,49705295;1
1097;319;221;18;239;-70,74481951;-33,49025728;1
1098;464;339;23;362;-70,73752339;-33,49708481;1
1099;71;58;0;58;-70,77162808;-33,4891363;1
1100;119;85;0;85;-70,75330904;-33,49275621;1
1101;76;58;10;68;-70,7397967;-33,47309119;1
1102;118;92;12;104;-70,76213768;-33,48942223;1
1103;94;63;16;79;-70,75615186;-33,48985738;1
1104;66;54;0;54;-70,74055317;-33,49007513;1
1105;113;75;10;85;-70,74346157;-33,48997111;1
1106;98;79;5;84;-70,77268092;-33,48931295;1
1107;204;148;31;179;-70,7614052;-33,49026828;1
1108;94;73;11;84;-70,74007535;-33,49006128;1
1109;65;50;0;50;-70,77703746;-33,48938318;1
1110;42;35;0;35;-70,76310123;-33,48935167;1
1111;133;101;16;117;-70,76028295;-33,48953229;1
1112;138;105;0;105;-70,76989902;-33,48958751;1
1113;98;81;10;91;-70,73600641;-33,4902002;1
1114;141;108;5;113;-70,76829159;-33,48954007;1
1115;87;66;0;66;-70,77742852;-33,48951936;1
1116;43;35;0;35;-70,73542674;-33,48978973;1
1117;92;75;8;83;-70,77159433;-33,48956215;1
1118;117;90;7;97;-70,75655902;-33,49002795;1
1119;822;614;38;652;-70,76439662;-33,4900599;1
1120;49;35;0;35;-70,77550794;-33,48937031;1
1121;95;78;7;85;-70,73917341;-33,48983444;1
1122;89;57;5;62;-70,78147427;-33,48941316;1
1123;90;71;0;71;-70,77779947;-33,48969226;1
1124;83;59;13;72;-70,73687949;-33,48990213;1
1125;166;114;16;130;-70,77971715;-33,48965875;1
1126;39;30;4;34;-70,77232724;-33,48952689;1
1127;84;69;5;74;-70,75696569;-33,49018706;1
1128;65;48;8;56;-70,76321345;-33,48960946;1
1129;78;57;9;66;-70,75892038;-33,48977217;1
1130;633;463;38;501;-70,76557134;-33,4901399;1
1131;82;66;0;66;-70,76953257;-33,48981243;1
1132;52;36;0;36;-70,76805946;-33,48983147;1
1133;92;68;0;68;-70,77816818;-33,48986465;1
1134;53;40;0;40;-70,76076082;-33,48978803;1
1135;55;40;0;40;-70,78080155;-33,48965637;1
1136;31;20;0;20;-70,73547598;-33,49013001;0
1137;179;133;11;144;-70,77698758;-33,49015847;1
1138;81;55;13;68;-70,75793652;-33,48994891;1
1139;180;128;7;135;-70,77438087;-33,48972961;1
1140;310;205;14;219;-70,78322253;-33,49034147;1
1141;102;81;7;88;-70,73914699;-33,49018077;1
1142;72;50;10;60;-70,76324253;-33,48982761;1
1143;79;67;0;67;-70,73694218;-33,49024958;1
1144;60;47;0;47;-70,75477148;-33,49030755;1
1145;99;66;11;77;-70,77856699;-33,49008553;1
1146;53;39;6;45;-70,76219941;-33,48995105;1
1147;62;50;0;50;-70,74422465;-33,49042129;1
1148;131;102;6;108;-70,75959441;-33,49051853;1
1149;342;245;23;268;-70,76674304;-33,49018979;1
1150;116;89;6;95;-70,76880752;-33,49008311;1
1151;94;69;12;81;-70,76054514;-33,49008494;1
1152;121;87;11;98;-70,77091278;-33,49002575;1
1153;110;78;7;85;-70,75911873;-33,49052259;1
1154;45;35;0;35;-70,77903669;-33,49008045;1
1155;51;33;0;33;-70,74384965;-33,49052187;1
1156;58;36;10;46;-70,76327417;-33,49004916;1
1157;62;41;6;47;-70,7586994;-33,49035503;1
1158;443;323;34;357;-70,77163953;-33,49100784;1
1159;204;152;4;156;-70,73318066;-33,49173003;1
1160;37;29;0;29;-70,73554303;-33,49056479;1
1161;104;77;8;85;-70,73909209;-33,49051744;1
1162;58;43;7;50;-70,75825755;-33,49037388;1
1163;158;105;13;118;-70,73720463;-33,49059051;1
1164;42;28;5;33;-70,77956722;-33,49007243;1
1165;43;35;0;35;-70,7433235;-33,49066524;1
1166;63;49;6;55;-70,75763955;-33,49036785;1
1167;52;38;0;38;-70,75539015;-33,49052329;1
1168;70;57;8;65;-70,76220623;-33,49029904;1
1169;150;107;9;116;-70,78104455;-33,49049533;1
1170;114;82;5;87;-70,77437225;-33,49055643;1
1171;60;43;6;49;-70,76330828;-33,49027135;1
1172;128;93;12;105;-70,76050201;-33,49042702;1
1173;139;108;4;112;-70,76974295;-33,49038035;1
1174;45;35;5;40;-70,77481521;-33,49058303;1
1175;105;67;16;83;-70,77396483;-33,4906846;1
1176;65;50;6;56;-70,74216328;-33,49088077;1
1177;317;221;22;243;-70,78255771;-33,4907383;1
1178;112;78;12;90;-70,7759986;-33,49061204;1
1179;105;81;0;81;-70,77355112;-33,49080814;1
1180;63;52;0;52;-70,76334249;-33,49048734;1
1181;31;27;0;27;-70,75516354;-33,49086928;1
1182;129;95;16;111;-70,75789916;-33,4908103;1
1183;117;88;10;98;-70,77314633;-33,49093341;1
1184;63;46;7;53;-70,76220618;-33,49068162;1
1185;55;36;12;48;-70,75592187;-33,49100419;1
1186;117;89;11;100;-70,7604539;-33,49076938;1
1187;106;77;11;88;-70,73969013;-33,49150373;1
1188;124;93;9;102;-70,73928134;-33,49152182;1
1189;86;68;0;68;-70,74009648;-33,49147456;1
1190;136;111;5;116;-70,73884689;-33,49157409;1
1191;91;67;11;78;-70,74049792;-33,49146084;1
1192;75;55;12;67;-70,74460257;-33,49121414;1
1193;128;101;9;110;-70,73832567;-33,49161987;1
1194;144;112;9;121;-70,7378857;-33,49163828;1
1195;35;26;5;31;-70,74099436;-33,49109914;1
1196;116;88;0;88;-70,73748818;-33,49166779;1
1197;62;46;8;54;-70,76337224;-33,49070647;1
1198;118;91;9;100;-70,73708465;-33,49169305;1
1199;100;84;0;84;-70,74554906;-33,49121256;1
1200;76;54;8;62;-70,74367017;-33,49105456;1
1201;71;53;8;61;-70,74242763;-33,49118039;1
1202;133;110;8;118;-70,73667822;-33,4917195;1
1203;140;112;6;118;-70,73628254;-33,4917736;1
1204;147;109;10;119;-70,73587007;-33,49186343;1
1205;57;43;0;43;-70,77556279;-33,49088574;1
1206;47;33;0;33;-70,75636509;-33,49116026;1
1207;521;376;39;415;-70,76575897;-33,4912759;1
1208;83;62;0;62;-70,78433156;-33,4908389;1
1209;74;47;0;47;-70,76341306;-33,49092412;1
1210;78;59;8;67;-70,75686347;-33,49137167;1
1211;52;33;11;44;-70,76179045;-33,49112817;1
1212;407;288;31;319;-70,78271286;-33,49225246;1
1213;92;65;10;75;-70,76040636;-33,49111068;1
1214;57;48;4;52;-70,76219148;-33,4911655;1
1215;69;56;0;56;-70,75735606;-33,49139597;1
1216;94;66;12;78;-70,74373162;-33,49134828;1
1217;41;29;4;33;-70,76263067;-33,4912312;1
1218;93;66;14;80;-70,74547648;-33,49152313;1
1219;61;40;12;52;-70,75775455;-33,4914713;1
1220;59;49;0;49;-70,7411101;-33,49145165;1
1221;65;46;8;54;-70,76344428;-33,49114378;1
1222;73;50;7;57;-70,75815934;-33,49151862;1
1223;64;50;0;50;-70,74242439;-33,49152739;1
1224;73;46;13;59;-70,7585664;-33,49155835;1
1225;323;215;12;227;-70,78080416;-33,49199165;1
1226;64;50;6;56;-70,75897248;-33,49160633;1
1227;170;131;16;147;-70,74603274;-33,49235682;1
1228;60;46;9;55;-70,74176117;-33,49186367;1
1229;85;64;0;64;-70,74378501;-33,49163462;1
1230;60;46;0;46;-70,75942026;-33,49165406;1
1231;169;125;10;135;-70,76818476;-33,49158082;1
1232;85;60;7;67;-70,77471941;-33,49133954;1
1233;550;400;30;430;-70,76464847;-33,49170241;1
1234;48;34;8;42;-70,7634829;-33,49136923;1
1235;62;44;9;53;-70,75982478;-33,4917138;1
1236;63;51;0;51;-70,74541063;-33,49181939;1
1237;249;160;11;171;-70,77756647;-33,49172758;1
1238;47;31;0;31;-70,76995329;-33,49146323;1
1239;54;38;8;46;-70,76022856;-33,49176738;1
1240;51;34;8;42;-70,74717119;-33,49182974;1
1241;42;36;0;36;-70,74116507;-33,49181781;1
1242;60;48;5;53;-70,76063123;-33,49180623;1
1243;65;45;10;55;-70,74245553;-33,49181979;1
1244;61;45;6;51;-70,76103663;-33,49184349;1
1245;69;49;6;55;-70,76144819;-33,49189544;1
1246;191;140;4;144;-70,78397289;-33,49211533;1
1247;63;42;11;53;-70,76184823;-33,49194451;1
1248;122;86;12;98;-70,74469742;-33,49244797;1
1249;77;56;10;66;-70,74383658;-33,49196715;1
1250;53;47;0;47;-70,76350985;-33,49162888;1
1251;59;41;5;46;-70,76224861;-33,49200102;1
1252;40;29;0;29;-70,7812417;-33,49152395;1
1253;62;47;5;52;-70,745346;-33,49211717;1
1254;161;121;9;130;-70,77319527;-33,4918163;1
1255;73;55;10;65;-70,76271366;-33,49207789;1
1256;60;52;0;52;-70,74699558;-33,49215179;1
1257;89;69;4;73;-70,77017724;-33,4917798;1
1258;201;144;13;157;-70,78358632;-33,4922256;1
1259;64;52;0;52;-70,74250057;-33,49210762;1
1260;66;51;4;55;-70,76355093;-33,49185091;1
1261;117;84;9;93;-70,74150031;-33,49273962;1
1262;108;81;6;87;-70,77494916;-33,49196341;1
1263;89;63;7;70;-70,74389326;-33,4922527;1
1264;58;32;0;32;-70,74071909;-33,49230784;1
1265;142;108;7;115;-70,78319319;-33,49232445;1
1266;614;438;77;515;-70,7400284;-33,49377973;1
1267;559;370;15;385;-70,77754825;-33,49262483;1
1268;20;15;0;15;-70,74874227;-33,49232957;0
1269;70;50;10;60;-70,74528264;-33,49241781;1
1270;107;80;0;80;-70,77051567;-33,4921264;1
1271;51;42;5;47;-70,74681791;-33,49246387;1
1272;58;44;4;48;-70,76358509;-33,49206348;1
1273;85;63;10;73;-70,74195092;-33,49280871;1
1274;99;83;10;93;-70,76862344;-33,49221417;1
1275;125;98;6;104;-70,73666864;-33,4933785;1
1276;273;207;15;222;-70,76750518;-33,49264098;1
1277;58;38;7;45;-70,7423881;-33,49285416;1
1278;86;63;12;75;-70,74966102;-33,49265029;1
1279;280;187;10;197;-70,78185804;-33,49283052;1
1280;163;115;23;138;-70,7709208;-33,49253561;1
1281;409;277;21;298;-70,77561815;-33,49259715;1
1282;45;32;6;38;-70,74082915;-33,49265568;1
1283;57;43;4;47;-70,76362169;-33,49229267;1
1284;148;116;0;116;-70,773417;-33,49244935;1
1285;107;75;7;82;-70,78169441;-33,49244042;1
1286;58;39;0;39;-70,7466433;-33,49277118;1
1287;30;25;0;25;-70,74522156;-33,49271538;1
1288;37;22;6;28;-70,74287777;-33,49289795;1
1289;126;77;31;108;-70,74820968;-33,4932766;1
1290;1489;1095;79;1174;-70,73325028;-33,49332603;1
1291;140;104;7;111;-70,7352759;-33,49310045;1
1292;46;33;0;33;-70,73952675;-33,49304134;1
1293;93;72;7;79;-70,74945331;-33,49303052;1
1294;85;55;4;59;-70,77832851;-33,49261255;1
1295;23;14;7;21;-70,74093445;-33,49299827;1
1296;27;21;0;21;-70,74624812;-33,49299854;1
1297;164;114;26;140;-70,74434036;-33,49330246;1
1298;105;83;12;95;-70,75095185;-33,49309538;1
1299;31;27;0;27;-70,74514863;-33,49304576;1
1300;574;407;27;434;-70,77269842;-33,49388475;1
1301;68;41;0;41;-70,77499655;-33,49282948;1
1302;114;76;0;76;-70,7758855;-33,49294581;1
1303;224;165;12;177;-70,77143837;-33,49308464;1
1304;19;13;6;19;-70,74666806;-33,49333874;0
1305;29;22;0;22;-70,74606057;-33,49332202;1
1306;55;39;6;45;-70,74103898;-33,49333756;1
1307;101;76;12;88;-70,74928713;-33,493414;1
1308;430;315;23;338;-70,73839747;-33,49547702;1
1309;116;86;15;101;-70,75012972;-33,49389502;1
1310;90;71;0;71;-70,7357638;-33,49361858;1
1311;98;60;13;73;-70,74261894;-33,49347293;1
1312;85;71;0;71;-70,76983263;-33,49320461;1
1313;75;53;7;60;-70,73540616;-33,49367;1
1314;187;137;19;156;-70,75273854;-33,49384019;1
1315;67;56;0;56;-70,73508761;-33,49372711;1
1316;399;286;15;301;-70,77531895;-33,49355701;1
1317;28;21;0;21;-70,7510464;-33,49349599;1
1318;48;41;0;41;-70,73476036;-33,49378262;1
1319;159;105;29;134;-70,74198162;-33,49430109;1
1320;85;49;20;69;-70,74412694;-33,49372606;1
1321;71;58;0;58;-70,73443514;-33,49383542;1
1322;309;187;56;243;-70,76284344;-33,49418558;1
1323;68;48;9;57;-70,74573899;-33,49370319;1
1324;86;65;5;70;-70,73412903;-33,49394072;1
1325;60;43;0;43;-70,77759409;-33,49342797;1
1326;87;67;6;73;-70,74910909;-33,49377489;1
1327;30;17;0;17;-70,74114542;-33,49370255;0
1328;80;61;0;61;-70,77308247;-33,49351906;1
1329;95;74;0;74;-70,73381225;-33,49398954;1
1330;72;55;7;62;-70,75057764;-33,49394633;1
1331;66;51;0;51;-70,7334822;-33,49399139;1
1332;76;60;0;60;-70,78195137;-33,49342831;1
1333;82;55;13;68;-70,7427106;-33,49380609;1
1334;74;59;0;59;-70,73316131;-33,49404138;1
1335;67;50;0;50;-70,73284582;-33,49409486;1
1336;327;233;14;247;-70,78348872;-33,49393669;1
1337;32;16;0;16;-70,78379889;-33,49340006;0
1338;80;64;0;64;-70,73250219;-33,4942035;1
1339;390;276;51;327;-70,74590326;-33,4947531;1
1340;60;47;7;54;-70,75101417;-33,49410839;1
1341;87;65;0;65;-70,73217804;-33,4942599;1
1342;98;75;0;75;-70,77886333;-33,49361898;1
1343;820;528;153;681;-70,76693924;-33,49486916;1
1344;204;145;7;152;-70,78195497;-33,49384389;1
1345;99;72;4;76;-70,73181168;-33,49432762;1
1346;0;0;0;0;-70,73574577;-33,49425688;0
1347;54;36;6;42;-70,74124956;-33,49403281;1
1348;101;79;10;89;-70,74892772;-33,49415497;1
1349;137;93;25;118;-70,74468283;-33,49411166;1
1350;106;60;30;90;-70,76063674;-33,49401366;1
1351;111;92;0;92;-70,73526088;-33,49447579;1
1352;76;48;8;56;-70,74280263;-33,49414312;1
1353;74;54;0;54;-70,77448992;-33,49375321;1
1354;76;54;5;59;-70,73996377;-33,49448288;1
1355;126;94;0;94;-70,73493397;-33,49453354;1
1356;403;284;18;302;-70,77884034;-33,49418404;1
1357;113;91;8;99;-70,75228661;-33,49428789;1
1358;129;96;6;102;-70,73460632;-33,49458574;1
1359;90;58;7;65;-70,73696011;-33,49440695;1
1360;51;29;12;41;-70,74135181;-33,49437123;1
1361;107;81;8;89;-70,73365788;-33,49474281;1
1362;114;87;6;93;-70,73430211;-33,49469109;1
1363;93;64;5;69;-70,77580791;-33,49410544;1
1364;72;58;0;58;-70,73333766;-33,49479096;1
1365;80;62;0;62;-70,7339883;-33,49473968;1
1366;124;98;0;98;-70,77435417;-33,49421934;1
1367;109;82;5;87;-70,73302178;-33,49484545;1
1368;37;27;0;27;-70,76124033;-33,49425026;1
1369;46;32;4;36;-70,74335562;-33,49463341;1
1370;51;42;4;46;-70,73927866;-33,49475961;1
1371;74;56;0;56;-70,74295121;-33,49469356;1
1372;92;69;17;86;-70,75209595;-33,49463692;1
1373;56;31;12;43;-70,75917359;-33,49440403;1
1374;60;43;7;50;-70,74254654;-33,49474618;1
1375;30;0;0;0;-70,75805747;-33,49456882;0
1376;49;38;0;38;-70,7323674;-33,49472544;1
1377;26;0;0;0;-70,76071054;-33,49440472;0
1378;133;98;9;107;-70,73853293;-33,49486619;1
1379;79;64;0;64;-70,73584936;-33,49471401;1
1380;44;35;0;35;-70,74764751;-33,49471084;1
1381;54;41;4;45;-70,75063544;-33,49466853;1
1382;344;245;13;258;-70,78182312;-33,49483788;1
1383;44;33;0;33;-70,7414564;-33,49471179;1
1384;24;14;0;14;-70,74912226;-33,49468846;0
1385;0;0;0;0;-70,73780154;-33,49485886;0
1386;70;56;0;56;-70,7772055;-33,49433364;1
1387;125;94;14;108;-70,73747416;-33,49499214;1
1388;71;47;0;47;-70,78175586;-33,49431452;1
1389;44;29;8;37;-70,76147208;-33,49457607;1
1390;117;94;8;102;-70,73674489;-33,4952859;1
1391;55;37;4;41;-70,76398404;-33,49449124;1
1392;45;34;0;34;-70,73254281;-33,49497557;1
1393;46;36;5;41;-70,75938663;-33,49479215;1
1394;125;94;6;100;-70,77582486;-33,49453267;1
1395;79;48;19;67;-70,75200207;-33,49504387;1
1396;54;32;15;47;-70,74968494;-33,49514252;1
1397;46;36;0;36;-70,73595524;-33,49500317;1
1398;65;50;0;50;-70,77873274;-33,49466701;1
1399;42;23;13;36;-70,76088879;-33,49483978;1
1400;241;165;41;206;-70,76125343;-33,49551554;1
1401;47;35;6;41;-70,74156604;-33,49507213;1
1402;86;60;4;64;-70,73553651;-33,49529173;1
1403;138;104;0;104;-70,77712908;-33,49484742;1
1404;57;32;14;46;-70,75012355;-33,49517305;1
1405;69;56;8;64;-70,73521015;-33,49534731;1
1406;69;45;9;54;-70,76327669;-33,49485019;1
1407;27;19;5;24;-70,76043666;-33,49497196;1
1408;34;25;0;25;-70,73270814;-33,49522268;1
1409;83;61;8;69;-70,73489679;-33,49539821;1
1410;80;61;9;70;-70,74440662;-33,49511683;1
1411;54;43;4;47;-70,76396651;-33,49484866;1
1412;59;47;0;47;-70,73458543;-33,49544831;1
1413;38;20;14;34;-70,75075117;-33,49516251;1
1414;24;15;0;15;-70,73608335;-33,49555421;0
1415;41;26;10;36;-70,74746133;-33,49528353;1
1416;39;26;0;26;-70,75843238;-33,49507469;1
1417;98;71;0;71;-70,78335965;-33,49489151;1
1418;76;59;5;64;-70,73426871;-33,49550086;1
1419;50;35;0;35;-70,76258596;-33,49508354;1
1420;25;17;4;21;-70,74351972;-33,49529906;1
1421;35;22;7;29;-70,75994013;-33,49511802;1
1422;111;92;5;97;-70,73342813;-33,49541996;1
1423;200;141;24;165;-70,7426779;-33,49599783;1
1424;56;36;5;41;-70,74274311;-33,4954648;1
1425;33;19;10;29;-70,75782824;-33,49542059;1
1426;42;28;10;38;-70,74234272;-33,49553026;1
1427;70;46;12;58;-70,75931672;-33,49529973;1
1428;60;33;20;53;-70,75192791;-33,49552047;1
1429;65;44;15;59;-70,74196626;-33,49563454;1
1430;18;0;0;0;-70,75315169;-33,49536844;0
1431;61;48;5;53;-70,74157563;-33,4956897;1
1432;68;49;11;60;-70,74447636;-33,49547428;1
1433;67;37;17;54;-70,76321808;-33,49521367;1
1434;138;93;4;97;-70,77864831;-33,49513381;1
1435;58;35;14;49;-70,74113133;-33,495781;1
1436;56;39;0;39;-70,76395579;-33,49522537;1
1437;84;64;5;69;-70,73358017;-33,49567211;1
1438;226;170;26;196;-70,74161971;-33,49705807;1
1439;147;96;11;107;-70,78320671;-33,49520997;1
1440;15;11;0;11;-70,75368864;-33,49552458;0
1441;75;51;15;66;-70,74047803;-33,49599376;1
1442;42;32;6;38;-70,75852482;-33,49553728;1
1443;14;0;0;0;-70,75698004;-33,49568913;0
1444;41;27;0;27;-70,75637358;-33,49572196;1
1445;212;148;26;174;-70,74022017;-33,49672386;1
1446;63;36;11;47;-70,76203008;-33,4957265;1
1447;109;73;14;87;-70,73960687;-33,49615461;1
1448;32;26;0;26;-70,73567799;-33,49590716;1
1449;77;57;0;57;-70,78152846;-33,49527485;1
1450;53;27;18;45;-70,75581346;-33,49579086;1
1451;144;92;38;130;-70,75961786;-33,49589766;1
1452;56;43;10;53;-70,75452725;-33,49575615;1
1453;235;182;20;202;-70,73938932;-33,49685431;1
1454;76;52;14;66;-70,74727281;-33,49585766;1
1455;69;53;5;58;-70,73537008;-33,4960412;1
1456;114;68;31;99;-70,75026947;-33,49574087;1
1457;70;53;0;53;-70,73370978;-33,49592625;1
1458;667;509;38;547;-70,73853326;-33,49656433;1
1459;70;56;0;56;-70,73506978;-33,4961542;1
1460;66;48;9;57;-70,74453173;-33,49580398;1
1461;33;25;5;30;-70,75529469;-33,49585104;1
1462;79;58;5;63;-70,73476763;-33,4962369;1
1463;69;47;17;64;-70,75340573;-33,49598779;1
1464;120;76;19;95;-70,76309874;-33,49558892;1
1465;60;42;9;51;-70,7640591;-33,49581644;1
1466;120;84;0;84;-70,73445693;-33,49630443;1
1467;513;386;16;402;-70,73732828;-33,49652875;1
1468;49;28;11;39;-70,75186688;-33,49600053;1
1469;164;111;10;121;-70,78157004;-33,49581843;1
1470;75;58;0;58;-70,73385575;-33,49617319;1
1471;104;71;14;85;-70,73641849;-33,49645423;1
1472;98;82;0;82;-70,73607083;-33,49654522;1
1473;62;46;7;53;-70,7434506;-33,49620142;1
1474;105;68;25;93;-70,75031078;-33,4961624;1
1475;56;39;10;49;-70,7446009;-33,49615613;1
1476;59;45;6;51;-70,76260215;-33,49602206;1
1477;56;38;6;44;-70,76316252;-33,49601498;1
1478;33;22;5;27;-70,76365273;-33,49600954;1
1479;85;56;0;56;-70,73574402;-33,49666714;1
1480;67;43;9;52;-70,76643708;-33,49611051;1
1481;95;54;33;87;-70,74707447;-33,49644523;1
1482;54;34;0;34;-70,7339795;-33,49642749;1
1483;59;40;7;47;-70,76693851;-33,4961312;1
1484;114;76;14;90;-70,74330131;-33,49661074;1
1485;47;29;16;45;-70,76744113;-33,49614936;1
1486;40;25;9;34;-70,76795382;-33,49616492;1
1487;131;94;0;94;-70,78304559;-33,49614049;1
1488;57;33;10;43;-70,76851662;-33,49617919;1
1489;107;75;18;93;-70,74197443;-33,49659654;1
1490;103;79;5;84;-70,73545403;-33,49694585;1
1491;96;53;27;80;-70,75644472;-33,49681431;1
1492;29;22;0;22;-70,73411734;-33,49670403;1
1493;76;43;22;65;-70,75512669;-33,49680702;1
1494;45;23;0;23;-70,75438678;-33,49665723;1
1495;172;101;53;154;-70,75210099;-33,49677079;1
1496;33;26;0;26;-70,72297376;-33,47348741;1
1497;107;88;4;92;-70,75444858;-33,47272219;1
1498;112;76;19;95;-70,74209142;-33,47326716;1
1499;86;56;15;71;-70,76365501;-33,49663898;1
1500;71;41;18;59;-70,72427717;-33,47335123;1
1501;22;16;0;16;-70,76297057;-33,49663593;0
1502;58;34;9;43;-70,76257474;-33,49664569;1
1503;305;204;54;258;-70,76119577;-33,49737421;1
1504;416;306;41;347;-70,75959026;-33,49806548;1
1505;63;47;0;47;-70,73450883;-33,4969806;1
1506;51;38;5;43;-70,74899389;-33,49677863;1
1507;87;61;14;75;-70,74344097;-33,49697742;1
1508;121;86;11;97;-70,7399354;-33,49738013;1
1509;87;61;10;71;-70,74083421;-33,49727492;1
1510;662;427;123;550;-70,74722623;-33,4980623;1
1511;89;65;14;79;-70,76455151;-33,49689875;1
1512;81;57;12;69;-70,76506365;-33,49691051;1
1513;85;65;9;74;-70,76556091;-33,49692274;1
1514;43;31;9;40;-70,74775172;-33,49704651;1
1515;48;26;14;40;-70,76658268;-33,49674272;1
1516;46;34;0;34;-70,74737784;-33,49710474;1
1517;39;24;10;34;-70,76711958;-33,49675378;1
1518;86;70;0;70;-70,73621978;-33,49713165;1
1519;105;68;16;84;-70,7680974;-33,49670525;1
1520;53;32;7;39;-70,74701456;-33,49715405;1
1521;95;60;21;81;-70,75054205;-33,49706246;1
1522;51;37;5;42;-70,74664747;-33,4972108;1
1523;514;330;101;431;-70,76976297;-33,49871481;1
1524;31;23;4;27;-70,74597006;-33,49716378;1
1525;45;26;10;36;-70,77109221;-33,49694965;1
1526;60;46;0;46;-70,73461523;-33,49727872;1
1527;66;45;10;55;-70,771874;-33,49709382;1
1528;97;73;11;84;-70,74208807;-33,49733472;1
1529;36;20;10;30;-70,77264689;-33,49698508;1
1530;67;44;9;53;-70,74352313;-33,49732349;1
1531;314;240;11;251;-70,73566129;-33,49754198;1
1532;482;364;22;386;-70,73767302;-33,49771542;1
1533;29;20;0;20;-70,77342185;-33,49724881;0
1534;195;106;62;168;-70,75272664;-33,49782343;1
1535;110;73;21;94;-70,75368493;-33,4979576;1
1536;143;89;33;122;-70,7543981;-33,49796259;1
1537;116;77;19;96;-70,75068692;-33,49758776;1
1538;116;83;15;98;-70,76808204;-33,49713225;1
1539;716;513;68;581;-70,76320724;-33,49783009;1
1540;50;35;0;35;-70,73472743;-33,49756328;1
1541;102;80;0;80;-70,73881905;-33,49758209;1
1542;160;103;21;124;-70,77513982;-33,49730707;1
1543;116;78;25;103;-70,7756108;-33,49742546;1
1544;85;53;17;70;-70,74576572;-33,49759112;1
1545;237;155;5;160;-70,76682664;-33,49766094;1
1546;1056;775;62;837;-70,74191764;-33,49976925;1
1547;72;53;12;65;-70,74355154;-33,49765452;1
1548;58;48;0;48;-70,73673157;-33,49780213;1
1549;38;24;10;34;-70,7478606;-33,49759397;1
1550;132;83;27;110;-70,7760404;-33,49755053;1
1551;28;21;0;21;-70,7831534;-33,49864998;1
1552;79;58;7;65;-70,7364014;-33,49788959;1
1553;36;24;6;30;-70,74748691;-33,49767053;1
1554;64;50;0;50;-70,73610211;-33,49796824;1
1555;125;78;22;100;-70,77648581;-33,49767178;1
1556;93;71;8;79;-70,73889564;-33,49786962;1
1557;101;70;22;92;-70,75512819;-33,49811214;1
1558;83;63;0;63;-70,73579938;-33,49801773;1
1559;182;116;39;155;-70,75688509;-33,49830135;1
1560;22;14;0;14;-70,74676097;-33,49780774;0
1561;91;54;23;77;-70,77187802;-33,49796724;1
1562;72;56;0;56;-70,73547318;-33,49806271;1
1563;45;31;7;38;-70,74639767;-33,49787374;1
1564;112;66;31;97;-70,77701139;-33,49778725;1
1565;39;27;6;33;-70,76447948;-33,4977338;1
1566;42;22;5;27;-70,76779237;-33,49757116;1
1567;129;95;10;105;-70,74230179;-33,49799021;1
1568;48;37;0;37;-70,74343885;-33,49797161;1
1569;400;262;73;335;-70,77476343;-33,4986607;1
1570;89;63;10;73;-70,73779797;-33,49816509;1
1571;40;26;0;26;-70,75199303;-33,49806711;1
1572;104;71;8;79;-70,73896423;-33,49815811;1
1573;34;28;0;28;-70,7348826;-33,4982494;1
1574;163;115;26;141;-70,77752637;-33,49795834;1
1575;35;25;7;32;-70,74506566;-33,49814339;1
1576;117;75;29;104;-70,75078091;-33,4982528;1
1577;103;75;14;89;-70,74237717;-33,49826381;1
1578;98;68;12;80;-70,77414199;-33,49879952;1
1579;138;88;21;109;-70,77794619;-33,49808162;1
1580;173;137;5;142;-70,73589077;-33,4985175;1
1581;123;89;15;104;-70,73999669;-33,49880999;1
1582;90;58;18;76;-70,76600884;-33,4982321;1
1583;105;66;15;81;-70,76650435;-33,49823908;1
1584;100;80;4;84;-70,73788822;-33,49844431;1
1585;89;65;8;73;-70,76699474;-33,49824885;1
1586;112;71;23;94;-70,77837134;-33,4982026;1
1587;77;43;17;60;-70,77356978;-33,49852961;1
1588;118;90;16;106;-70,73881834;-33,49899781;1
1589;91;54;17;71;-70,76791203;-33,49826991;1
1590;73;45;18;63;-70,76847586;-33,49828113;1
1591;338;229;49;278;-70,74720906;-33,49906545;1
1592;106;70;16;86;-70,77526476;-33,49817642;1
1593;31;19;7;26;-70,76186694;-33,49829957;1
1594;86;56;13;69;-70,74238514;-33,49868682;1
1595;208;150;10;160;-70,73611682;-33,49876735;1
1596;93;62;21;83;-70,77244624;-33,49849921;1
1597;38;22;0;22;-70,76452371;-33,49837599;1
1598;44;25;13;38;-70,76504515;-33,49838941;1
1599;57;33;0;33;-70,76551204;-33,49840129;1
1600;107;81;10;91;-70,73803488;-33,4988017;1
1601;64;39;12;51;-70,73958195;-33,49907339;1
1602;16;0;0;0;-70,74416987;-33,49920474;0
1603;204;167;9;176;-70,73623771;-33,49901471;1
1604;66;45;11;56;-70,73923986;-33,49915088;1
1605;139;92;25;117;-70,75080984;-33,49898124;1
1606;31;17;0;17;-70,75219996;-33,49863949;0
1607;251;173;4;177;-70,78936505;-33,49937638;1
1608;0;0;0;0;-70,78092269;-33,49943974;0
1609;200;158;7;165;-70,73632036;-33,4992751;1
1610;448;325;54;379;-70,75886525;-33,49920579;1
1611;75;55;5;60;-70,73851027;-33,49929018;1
1612;115;70;27;97;-70,74915179;-33,49926798;1
1613;233;136;58;194;-70,7611831;-33,49923656;1
1614;118;81;22;103;-70,77665523;-33,49888639;1
1615;76;50;14;64;-70,77747406;-33,49888655;1
1616;68;55;8;63;-70,73815165;-33,49934733;1
1617;128;82;20;102;-70,77623604;-33,49892813;1
1618;135;78;35;113;-70,76313711;-33,49927932;1
1619;67;44;12;56;-70,77296587;-33,49920917;1
1620;90;57;7;64;-70,73778446;-33,49940673;1
1621;148;86;30;116;-70,77583074;-33,49896871;1
1622;75;51;14;65;-70,77128976;-33,49919727;1
1623;123;77;22;99;-70,7525614;-33,49948798;1
1624;98;62;23;85;-70,75358338;-33,49960431;1
1625;284;172;60;232;-70,76543287;-33,4991533;1
1626;141;83;33;116;-70,77538177;-33,49901246;1
1627;87;59;19;78;-70,75439874;-33,49959088;1
1628;152;98;32;130;-70,75604043;-33,49962376;1
1629;191;143;7;150;-70,73642212;-33,49954291;1
1630;82;55;0;55;-70,76717078;-33,49897702;1
1631;62;44;12;56;-70,7681641;-33,49900311;1
1632;36;21;0;21;-70,77076631;-33,49929206;1
1633;149;89;26;115;-70,77831003;-33,49933074;1
1634;27;16;5;21;-70,77222093;-33,49910238;1
1635;101;67;23;90;-70,7509721;-33,49982278;1
1636;73;44;19;63;-70,76963723;-33,49948186;1
1637;215;160;12;172;-70,73651526;-33,4998568;1
1638;133;72;44;116;-70,7448017;-33,5007848;1
1639;123;88;12;100;-70,74034127;-33,50022072;1
1640;250;158;53;211;-70,74671487;-33,50003352;1
1641;83;61;5;66;-70,76715884;-33,4993869;1
1642;67;43;7;50;-70,74927119;-33,50005479;1
1643;58;37;10;47;-70,76806027;-33,49946525;1
1644;81;59;8;67;-70,73826468;-33,49984674;1
1645;111;68;16;84;-70,73989129;-33,50035368;1
1646;47;28;11;39;-70,74426185;-33,50006704;1
1647;114;82;22;104;-70,73955319;-33,50044962;1
1648;131;84;26;110;-70,7392153;-33,50055464;1
1649;91;54;18;72;-70,77391761;-33,49953976;1
1650;64;47;10;57;-70,77214796;-33,49955229;1
1651;88;57;17;74;-70,73732983;-33,5003312;1
1652;77;49;15;64;-70,77744145;-33,49960213;1
1653;76;44;11;55;-70,77786315;-33,49961558;1
1654;80;55;17;72;-70,74315009;-33,50030932;1
1655;53;29;18;47;-70,76618646;-33,50000367;1
1656;69;57;0;57;-70,7383258;-33,50015407;1
1657;194;134;26;160;-70,73691652;-33,50097671;1
1658;48;32;12;44;-70,76982134;-33,49995273;1
1659;154;104;27;131;-70,76526631;-33,5001541;1
1660;19;12;0;12;-70,76709088;-33,49983538;0
1661;509;338;9;347;-70,79463272;-33,49985609;1
1662;155;102;14;116;-70,76840835;-33,50028499;1
1663;188;136;17;153;-70,73632589;-33,50102927;1
1664;16;10;0;10;-70,75810317;-33,5000907;0
1665;120;87;23;110;-70,75951446;-33,50055969;1
1666;373;257;56;313;-70,76114205;-33,50057986;1
1667;175;115;0;115;-70,78750276;-33,50053548;1
1668;86;52;17;69;-70,76783225;-33,50039326;1
1669;148;105;18;123;-70,76306617;-33,50061214;1
1670;83;61;8;69;-70,73840487;-33,50046326;1
1671;65;42;12;54;-70,77102911;-33,50000217;1
1672;52;26;15;41;-70,74785023;-33,50042244;1
1673;53;33;9;42;-70,7721454;-33,50009866;1
1674;89;66;14;80;-70,77295412;-33,50037109;1
1675;95;60;18;78;-70,77393967;-33,50004861;1
1676;59;37;13;50;-70,74355917;-33,50070071;1
1677;45;31;6;37;-70,77490844;-33,50002347;1
1678;41;24;9;33;-70,76725091;-33,50048331;1
1679;75;43;22;65;-70,74643671;-33,50056297;1
1680;134;90;27;117;-70,7525806;-33,50131881;1
1681;214;141;33;174;-70,75102839;-33,50082816;1
1682;76;42;22;64;-70,77739939;-33,50025124;1
1683;639;401;135;536;-70,75628061;-33,50193742;1
1684;35;25;0;25;-70,76451933;-33,50031703;1
1685;143;87;26;113;-70,77781347;-33,50043539;1
1686;145;104;23;127;-70,75495104;-33,50116692;1
1687;77;57;4;61;-70,77825713;-33,50028838;1
1688;73;56;10;66;-70,73847795;-33,50076991;1
1689;101;65;0;65;-70,78709233;-33,50056694;1
1690;27;20;4;24;-70,74287018;-33,50154399;1
1691;195;137;31;168;-70,74936267;-33,50105058;1
1692;178;106;44;150;-70,77018059;-33,5005606;1
1693;161;88;49;137;-70,76568902;-33,50100888;1
1694;49;34;7;41;-70,77496178;-33,50037022;1
1695;96;61;15;76;-70,73754762;-33,50129891;1
1696;83;47;20;67;-70,77431712;-33,50058695;1
1697;41;24;9;33;-70,74841271;-33,50100909;1
1698;52;32;12;44;-70,77363991;-33,50059186;1
1699;235;144;54;198;-70,74757402;-33,5015447;1
1700;72;44;0;44;-70,73894962;-33,50115698;1
1701;80;52;13;65;-70,77214338;-33,50063866;1
1702;37;31;0;31;-70,74041812;-33,50134438;1
1703;118;78;0;78;-70,78820855;-33,50073511;1
1704;259;153;56;209;-70,74580058;-33,50235169;1
1705;52;36;7;43;-70,73859463;-33,50125353;1
1706;137;91;0;91;-70,78853832;-33,50082785;1
1707;73;51;0;51;-70,78085479;-33,50062137;1
1708;66;48;10;58;-70,73823489;-33,50134734;1
1709;129;89;0;89;-70,79508995;-33,50055478;1
1710;119;81;4;85;-70,78886045;-33,50091715;1
1711;31;0;0;0;-70,77500301;-33,50071475;0
1712;92;65;16;81;-70,74477155;-33,50159254;1
1713;102;66;24;90;-70,75324956;-33,5016191;1
1714;96;57;18;75;-70,77735986;-33,50094647;1
1715;108;64;26;90;-70,77653699;-33,50097131;1
1716;129;87;0;87;-70,78918338;-33,50100829;1
1717;68;50;11;61;-70,77612211;-33,50101515;1
1718;107;56;25;81;-70,77822098;-33,50098315;1
1719;130;74;28;102;-70,77566834;-33,50105137;1
1720;133;97;0;97;-70,78950536;-33,50109684;1
1721;108;75;7;82;-70,78208648;-33,5009641;1
1722;71;55;7;62;-70,73980721;-33,50168006;1
1723;60;36;15;51;-70,76646133;-33,50132707;1
1724;129;91;0;91;-70,78982847;-33,50118336;1
1725;58;35;0;35;-70,78104324;-33,50112981;1
1726;82;50;26;76;-70,7511907;-33,50157325;1
1727;87;57;9;66;-70,76771216;-33,50169363;1
1728;84;64;7;71;-70,73948389;-33,50180883;1
1729;82;56;11;67;-70,76840696;-33,50151735;1
1730;71;52;0;52;-70,79034862;-33,50136953;1
1731;105;64;27;91;-70,76914435;-33,5015817;1
1732;142;93;14;107;-70,77020602;-33,50120913;1
1733;140;86;28;114;-70,7712438;-33,50177394;1
1734;25;13;0;13;-70,77191682;-33,50116877;0
1735;36;19;12;31;-70,77246844;-33,501416;1
1736;396;277;7;284;-70,79503074;-33,50091211;1
1737;58;42;0;42;-70,77511171;-33,5011152;1
1738;26;18;0;18;-70,77300198;-33,50117492;0
1739;59;35;15;50;-70,77365257;-33,50118454;1
1740;49;35;0;35;-70,7743616;-33,50118948;1
1741;85;67;0;67;-70,73916234;-33,50193267;1
1742;53;31;5;36;-70,74825775;-33,50159654;1
1743;82;52;5;57;-70,78181559;-33,50122687;1
1744;108;74;28;102;-70,75853742;-33,50229101;1
1745;81;63;11;74;-70,73883361;-33,5020366;1
1746;102;65;18;83;-70,74180512;-33,50236264;1
1747;396;295;52;347;-70,76107524;-33,50247015;1
1748;78;51;19;70;-70,74953392;-33,5018656;1
1749;32;22;7;29;-70,77503936;-33,50144919;1
1750;593;435;68;503;-70,76301037;-33,50250286;1
1751;93;68;6;74;-70,73847611;-33,50218472;1
1752;147;102;16;118;-70,73729907;-33,50219386;1
1753;46;36;0;36;-70,79428647;-33,50120238;1
1754;134;80;32;112;-70,74332659;-33,50246124;1
1755;40;30;0;30;-70,7949489;-33,5013106;1
1756;72;39;20;59;-70,74498162;-33,50216502;1
1757;180;126;24;150;-70,76453195;-33,50253849;1
1758;28;20;0;20;-70,77191709;-33,50163753;0
1759;95;58;24;82;-70,77731788;-33,50171861;1
1760;127;84;23;107;-70,75126347;-33,50210703;1
1761;36;25;8;33;-70,7730036;-33,50164182;1
1762;124;77;21;98;-70,77665642;-33,50180638;1
1763;93;59;12;71;-70,77403824;-33,50166654;1
1764;45;27;12;39;-70,7698615;-33,5019112;1
1765;101;53;26;79;-70,77817715;-33,50176082;1
1766;84;57;0;57;-70,79558636;-33,50140655;1
1767;66;40;11;51;-70,77057305;-33,50197443;1
1768;100;58;17;75;-70,77623503;-33,50184455;1
1769;133;81;29;110;-70,77578389;-33,50188588;1
1770;186;128;0;128;-70,78897756;-33,50169569;1
1771;75;51;4;55;-70,79622827;-33,50150805;1
1772;62;37;15;52;-70,74131308;-33,50274448;1
1773;47;32;0;32;-70,79654829;-33,50159784;1
1774;191;129;30;159;-70,76660682;-33,50272742;1
1775;121;95;10;105;-70,77519171;-33,5024725;1
1776;112;72;6;78;-70,79161251;-33,50218629;1
1777;84;62;14;76;-70,74961055;-33,50241124;1
1778;52;31;11;42;-70,75498276;-33,5024032;1
1779;104;72;0;72;-70,78333288;-33,50206819;1
1780;193;127;0;127;-70,78890851;-33,50197308;1
1781;176;113;8;121;-70,78945561;-33,50452355;1
1782;49;27;12;39;-70,75423703;-33,50245814;1
1783;0;0;0;0;-70,7374481;-33,50270351;0
1784;131;86;21;107;-70,77770972;-33,50227005;1
1785;49;27;11;38;-70,77191608;-33,50225251;1
1786;109;76;0;76;-70,79480154;-33,50176311;1
1787;70;40;22;62;-70,77272689;-33,50213133;1
1788;202;127;8;135;-70,78747926;-33,50253205;1
1789;59;43;0;43;-70,74538051;-33,50266677;1
1790;119;65;34;99;-70,74364415;-33,50290725;1
1791;221;151;0;151;-70,79229845;-33,50241881;1
1792;140;110;10;120;-70,76767047;-33,50282628;1
1793;190;134;0;134;-70,78467051;-33,50264885;1
1794;60;34;16;50;-70,77356075;-33,50226806;1
1795;17;11;0;11;-70,77404808;-33,50226995;0
1796;45;26;10;36;-70,77454155;-33,50226151;1
1797;219;157;6;163;-70,79262051;-33,50248646;1
1798;38;28;0;28;-70,77531829;-33,50211178;1
1799;398;258;87;345;-70,75091065;-33,50329531;1
1800;53;35;10;45;-70,74763455;-33,50270782;1
1801;242;159;5;164;-70,79294788;-33,50254473;1
1802;54;34;11;45;-70,74087466;-33,50304244;1
1803;229;153;0;153;-70,78561794;-33,50273048;1
1804;239;166;7;173;-70,78687266;-33,50319677;1
1805;243;162;5;167;-70,79327274;-33,50260712;1
1806;44;26;13;39;-70,74487667;-33,5028805;1
1807;117;79;21;100;-70,7683679;-33,50289452;1
1808;229;161;5;166;-70,7963496;-33,50199714;1
1809;34;27;5;32;-70,74843637;-33,5026852;1
1810;35;22;0;22;-70,74705063;-33,50281485;1
1811;130;98;4;102;-70,78883254;-33,50224934;1
1812;111;66;23;89;-70,75954428;-33,50296056;1
1813;261;164;0;164;-70,79359946;-33,50266129;1
1814;141;103;0;103;-70,79036954;-33,50270612;1
1815;241;156;0;156;-70,79392096;-33,50272265;1
1816;48;33;11;44;-70,77727541;-33,50242538;1
1817;59;40;12;52;-70,75293882;-33,50303213;1
1818;12;0;0;0;-70,75462077;-33,50264735;0
1819;67;41;15;56;-70,77813607;-33,50246178;1
1820;32;19;0;19;-70,74037492;-33,50306671;0
1821;209;138;0;138;-70,79419901;-33,50288936;1
1822;73;48;0;48;-70,78706085;-33,50255993;1
1823;62;44;0;44;-70,79510523;-33,50226676;1
1824;86;61;13;74;-70,74401036;-33,50326406;1
1825;90;53;0;53;-70,78344324;-33,50257513;1
1826;85;61;0;61;-70,7851571;-33,50266224;1
1827;72;54;0;54;-70,79542912;-33,50232946;1
1828;89;56;0;56;-70,79025439;-33,50237509;1
1829;37;21;10;31;-70,73996023;-33,50323266;1
1830;157;112;4;116;-70,79566581;-33,50266738;1
1831;36;18;12;30;-70,74634;-33,5030618;1
1832;48;28;0;28;-70,78610697;-33,50239715;1
1833;179;100;50;150;-70,74166021;-33,5034766;1
1834;134;82;26;108;-70,74938042;-33,50363497;1
1835;155;109;0;109;-70,79598856;-33,50272705;1
1836;31;18;8;26;-70,76554013;-33,50278841;1
1837;142;93;0;93;-70,79631206;-33,50279123;1
1838;47;30;6;36;-70,74853277;-33,50320413;1
1839;117;74;27;101;-70,74472225;-33,50359122;1
1840;167;107;0;107;-70,79662937;-33,50286337;1
1841;45;27;8;35;-70,73934778;-33,50331803;1
1842;176;120;6;126;-70,79694385;-33,50292631;1
1843;48;32;0;32;-70,79470012;-33,50278905;1
1844;45;30;8;38;-70,77191542;-33,50322181;1
1845;66;43;11;54;-70,74785299;-33,50366009;1
1846;127;75;33;108;-70,77246712;-33,50355611;1
1847;21;16;0;16;-70,79733944;-33,50281818;0
1848;33;18;10;28;-70,77299865;-33,50295166;1
1849;57;34;13;47;-70,77356191;-33,50304114;1
1850;35;22;5;27;-70,774106;-33,5030403;1
1851;82;51;13;64;-70,73888269;-33,50378718;1
1852;51;35;9;44;-70,77465976;-33,50304671;1
1853;508;351;52;403;-70,77537848;-33,50408563;1
1854;51;27;5;32;-70,78611573;-33,50273256;1
1855;763;531;23;554;-70,78020781;-33,50479512;1
1856;36;21;0;21;-70,74670263;-33,50352081;1
1857;53;31;10;41;-70,74038067;-33,50361146;1
1858;70;40;22;62;-70,77723756;-33,50313103;1
1859;89;62;14;76;-70,77766323;-33,50314659;1
1860;122;77;29;106;-70,73790138;-33,5036715;1
1861;69;36;24;60;-70,77809982;-33,50316324;1
1862;59;34;16;50;-70,73934309;-33,50389314;1
1863;48;25;14;39;-70,74215705;-33,50384273;1
1864;56;33;16;49;-70,74880695;-33,50396436;1
1865;56;38;0;38;-70,78109244;-33,50341787;1
1866;70;51;0;51;-70,78152357;-33,50345861;1
1867;192;116;51;167;-70,74431643;-33,50460495;1
1868;85;63;13;76;-70,73801071;-33,50399505;1
1869;53;37;8;45;-70,77300296;-33,50345613;1
1870;764;532;49;581;-70,77635714;-33,50426584;1
1871;234;157;37;194;-70,75122703;-33,50535152;1
1872;89;58;0;58;-70,79436842;-33,50335315;1
1873;202;146;39;185;-70,75316125;-33,50406637;1
1874;24;0;0;0;-70,74168995;-33,50405132;0
1875;43;35;0;35;-70,74733848;-33,50406443;1
1876;94;68;13;81;-70,77116126;-33,50382217;1
1877;151;95;32;127;-70,74248194;-33,5043902;1
1878;206;138;28;166;-70,75570404;-33,50454634;1
1879;105;75;0;75;-70,79466995;-33,50343866;1
1880;48;29;10;39;-70,74657157;-33,5040341;1
1881;187;134;24;158;-70,77373981;-33,50371587;1
1882;50;30;0;30;-70,79731487;-33,50326436;1
1883;209;144;5;149;-70,79222248;-33,50345397;1
1884;95;68;0;68;-70,79499062;-33,50351109;1
1885;87;60;22;82;-70,75950841;-33,50457214;1
1886;138;82;34;116;-70,76058708;-33,50458161;1
1887;175;129;28;157;-70,76147707;-33,50456849;1
1888;52;29;15;44;-70,76214282;-33,50409831;1
1889;38;23;7;30;-70,74118242;-33,50426783;1
1890;286;172;71;243;-70,76239353;-33,5050305;1
1891;113;71;26;97;-70,73810446;-33,50428184;1
1892;123;81;25;106;-70,76496973;-33,50386735;1
1893;196;132;36;168;-70,74073102;-33,50465859;1
1894;35;25;0;25;-70,76657224;-33,50458263;1
1895;186;129;25;154;-70,76762668;-33,504579;1
1896;79;45;16;61;-70,72889249;-33,47340095;1
1897;142;106;14;120;-70,74944345;-33,47285212;1
1898;65;45;7;52;-70,72583653;-33,4733291;1
1899;88;62;12;74;-70,7347363;-33,47367591;1
1900;79;56;11;67;-70,72507833;-33,47352665;1
1901;143;118;9;127;-70,75364321;-33,4733403;1
1902;88;70;8;78;-70,74783173;-33,47296737;1
1903;71;52;13;65;-70,72780939;-33,47348666;1
1904;176;135;12;147;-70,75330689;-33,47336606;1
1905;147;115;13;128;-70,75297214;-33,47339447;1
1906;186;135;16;151;-70,75264181;-33,47341728;1
1907;71;48;10;58;-70,7372005;-33,47347227;1
1908;180;135;13;148;-70,7523135;-33,47343912;1
1909;146;106;18;124;-70,74443751;-33,47311054;1
1910;77;52;8;60;-70,74653981;-33,47305989;1
1911;86;56;14;70;-70,72920919;-33,47360987;1
1912;54;39;10;49;-70,72666401;-33,47346421;1
1913;108;84;8;92;-70,75442649;-33,47299333;1
1914;70;49;10;59;-70,74001686;-33,4733772;1
1915;125;87;15;102;-70,74230304;-33,47353739;1
1916;94;76;7;83;-70,74949442;-33,47310967;1
1917;55;44;7;51;-70,73562988;-33,47344928;1
1918;84;54;16;70;-70,72481027;-33,47376598;1
1919;96;75;5;80;-70,74786064;-33,47322408;1
1920;63;41;12;53;-70,7368012;-33,47369746;1
1921;153;117;13;130;-70,74082806;-33,47436237;1
1922;63;45;9;54;-70,72387115;-33,473766;1
1923;73;44;17;61;-70,73005752;-33,47383413;1
1924;73;47;17;64;-70,72755602;-33,4737937;1
1925;97;69;4;73;-70,74653723;-33,47332027;1
1926;35;24;6;30;-70,7317461;-33,47384573;1
1927;53;37;11;48;-70,72616618;-33,47383477;1
1928;80;59;0;59;-70,75440862;-33,47326078;1
1929;124;93;14;107;-70,74248178;-33,47382745;1
1930;150;113;18;131;-70,74441061;-33,47343392;1
1931;123;91;6;97;-70,74951253;-33,47336943;1
1932;59;39;7;46;-70,72697334;-33,47390727;1
1933;65;48;7;55;-70,73546246;-33,47377386;1
1934;60;40;12;52;-70,72358483;-33,47401697;1
1935;60;45;0;45;-70,73819553;-33,4738915;1
1936;115;91;5;96;-70,74789846;-33,47348066;1
1937;59;40;11;51;-70,73225182;-33,47410161;1
1938;92;60;11;71;-70,72869544;-33,47406847;1
1939;92;64;10;74;-70,74654315;-33,47358225;1
1940;30;21;6;27;-70,72942684;-33,47394237;1
1941;62;41;16;57;-70,72425638;-33,47418996;1
1942;79;52;18;70;-70,72540883;-33,47416132;1
1943;64;52;0;52;-70,75439243;-33,47352509;1
1944;130;102;11;113;-70,74955253;-33,47362537;1
1945;77;58;9;67;-70,73268344;-33,47432677;1
1946;136;101;17;118;-70,74441373;-33,47375761;1
1947;92;67;16;83;-70,74260556;-33,47415653;1
1948;106;87;6;93;-70,74792535;-33,47373667;1
1949;58;40;12;52;-70,73742696;-33,47411272;1
1950;59;40;12;52;-70,73527844;-33,47409042;1
1951;79;51;15;66;-70,72570119;-33,47436743;1
1952;138;113;8;121;-70,75129533;-33,47375463;1
1953;78;51;18;69;-70,7245502;-33,47440425;1
1954;83;66;7;73;-70,74655097;-33,47384303;1
1955;56;37;13;50;-70,72689233;-33,47433604;1
1956;62;43;6;49;-70,72833374;-33,4743019;1
1957;68;43;8;51;-70,72289738;-33,47472368;1
1958;75;58;0;58;-70,73314319;-33,47455826;1
1959;73;53;9;62;-70,73678196;-33,47440458;1
1960;75;58;0;58;-70,75437804;-33,47379086;1
1961;119;96;8;104;-70,74958485;-33,47388367;1
1962;80;56;17;73;-70,7265434;-33,47458015;1
1963;107;89;5;94;-70,74796402;-33,47399508;1
1964;41;0;0;0;-70,74521026;-33,47417049;0
1965;52;38;10;48;-70,74563851;-33,47441656;1
1966;45;37;4;41;-70,7447859;-33,47421003;1
1967;29;16;9;25;-70,73054429;-33,47434645;1
1968;73;55;6;61;-70,74442728;-33,47446157;1
1969;60;48;8;56;-70,73585804;-33,47446698;1
1970;73;60;7;67;-70,74403844;-33,47447922;1
1971;82;64;11;75;-70,73357599;-33,47478943;1
1972;140;103;11;114;-70,75132393;-33,47401617;1
1973;56;42;8;50;-70,74363207;-33,47450484;1
1974;54;37;8;45;-70,73509885;-33,47440236;1
1975;91;70;12;82;-70,74653671;-33,47410228;1
1976;112;81;19;100;-70,73890722;-33,4747893;1
1977;53;36;7;43;-70,74302473;-33,4743975;1
1978;124;94;7;101;-70,74962665;-33,47413424;1
1979;79;61;4;65;-70,75436176;-33,47409019;1
1980;167;118;18;136;-70,75306245;-33,47418566;1
1981;67;46;11;57;-70,72825696;-33,47474558;1
1982;53;31;10;41;-70,72974372;-33,47455713;1
1983;88;60;13;73;-70,72523516;-33,47483634;1
1984;88;60;12;72;-70,72628638;-33,47483634;1
1985;101;76;15;91;-70,73400104;-33,47499923;1
1986;117;88;10;98;-70,7479975;-33,47425514;1
1987;96;68;14;82;-70,72369776;-33,47493276;1
1988;63;48;10;58;-70,7376564;-33,47473549;1
1989;127;96;15;111;-70,7513562;-33,47431074;1
1990;69;45;10;55;-70,72885444;-33,47490903;1
1991;115;85;6;91;-70,74654882;-33,47435796;1
1992;105;77;12;89;-70,73846611;-33,47504587;1
1993;119;87;12;99;-70,74966188;-33,47442803;1
1994;58;41;10;51;-70,7349037;-33,47474934;1
1995;725;562;38;600;-70,75578712;-33,47549955;1
1996;50;34;11;45;-70,74248368;-33,4747566;1
1997;55;39;9;48;-70,72926983;-33,47501391;1
1998;63;38;11;49;-70,7277876;-33,47492385;1
1999;76;48;10;58;-70,73035265;-33,47496998;1
2000;71;45;16;61;-70,7249661;-33,47508678;1
2001;98;71;12;83;-70,74803606;-33,47455532;1
2002;68;42;14;56;-70,73206431;-33,47515089;1
2003;69;52;7;59;-70,72975046;-33,475002;1
2004;70;53;4;57;-70,75486775;-33,4748097;1
2005;74;53;0;53;-70,75442326;-33,47476164;1
2006;93;69;9;78;-70,73650097;-33,47495629;1
2007;97;71;12;83;-70,74655161;-33,47466401;1
2008;53;40;5;45;-70,74501746;-33,47471967;1
2009;163;120;11;131;-70,75267747;-33,47465989;1
2010;82;56;14;70;-70,72754862;-33,47524597;1
2011;12;0;0;0;-70,74304383;-33,47486673;0
2012;99;69;9;78;-70,73473263;-33,47506798;1
2013;61;42;11;53;-70,72581628;-33,47532535;1
2014;1329;971;99;1070;-70,75258352;-33,47830242;1
2015;51;37;6;43;-70,73736148;-33,47512045;1
2016;106;80;8;88;-70,73532998;-33,47542197;1
2017;75;52;5;57;-70,72853455;-33,47538389;1
2018;56;39;9;48;-70,74863103;-33,47516597;1
2019;70;52;12;64;-70,7362427;-33,47527617;1
2020;74;61;5;66;-70,74818812;-33,47519444;1
2021;61;42;12;54;-70,72612622;-33,4755456;1
2022;114;79;16;95;-70,72730567;-33,47550387;1
2023;39;30;6;36;-70,72367041;-33,47538993;1
2024;60;48;5;53;-70,74778207;-33,47522436;1
2025;63;41;10;51;-70,7473776;-33,47524759;1
2026;131;84;18;102;-70,74656468;-33,47530549;1
2027;64;50;8;58;-70,73822247;-33,4754633;1
2028;56;37;10;47;-70,74619183;-33,47533379;1
2029;63;45;5;50;-70,73455165;-33,47538872;1
2030;134;99;11;110;-70,75267525;-33,47503767;1
2031;91;64;17;81;-70,72394403;-33,47571904;1
2032;93;67;11;78;-70,74578626;-33,475492;1
2033;1480;1119;45;1164;-70,7584871;-33,47912258;1
2034;93;66;11;77;-70,74538529;-33,47551353;1
2035;80;67;5;72;-70,74500749;-33,47554552;1
2036;89;64;10;74;-70,74462523;-33,47558027;1
2037;53;40;8;48;-70,73173906;-33,47561554;1
2038;69;50;9;59;-70,73078295;-33,47562594;1
2039;88;61;16;77;-70,74423692;-33,47560611;1
2040;79;53;12;65;-70,74385663;-33,47557032;1
2041;34;21;4;25;-70,72647089;-33,47578023;1
2042;46;32;0;32;-70,74346147;-33,47554633;1
2043;127;92;15;107;-70,72312884;-33,47609483;1
2044;71;58;0;58;-70,74306714;-33,47557163;1
2045;72;53;6;59;-70,74267898;-33,47559572;1
2046;72;56;6;62;-70,73607217;-33,47559857;1
2047;63;46;8;54;-70,74229408;-33,47562455;1
2048;101;76;12;88;-70,72415314;-33,47599587;1
2049;86;57;0;57;-70,7300059;-33,47553057;1
2050;62;47;11;58;-70,74190852;-33,47566009;1
2051;39;25;8;33;-70,72921263;-33,47568;1
2052;20;15;0;15;-70,74148589;-33,47559319;0
2053;69;50;10;60;-70,72799023;-33,47586749;1
2054;78;58;11;69;-70,73262935;-33,47575772;1
2055;24;15;6;21;-70,74106446;-33,47576107;1
2056;142;101;19;120;-70,7372813;-33,4757303;1
2057;22;15;0;15;-70,73411146;-33,47568245;0
2058;85;50;17;67;-70,73977573;-33,47594695;1
2059;76;52;10;62;-70,72679517;-33,47596337;1
2060;121;100;6;106;-70,7527157;-33,47536927;1
2061;57;44;8;52;-70,72828833;-33,47605385;1
2062;111;80;14;94;-70,7244376;-33,47620958;1
2063;89;59;11;70;-70,73585228;-33,47597849;1
2064;77;55;6;61;-70,73000394;-33,47586207;1
2065;80;60;11;71;-70,73931403;-33,47617948;1
2066;25;18;0;18;-70,72586903;-33,47633543;0
2067;145;101;12;113;-70,74987319;-33,47568393;1
2068;58;42;6;48;-70,72908336;-33,47613354;1
2069;60;43;6;49;-70,75293421;-33,47569672;1
2070;89;55;15;70;-70,72749599;-33,47632982;1
2071;100;67;18;85;-70,74809759;-33,47582341;1
2072;62;46;8;54;-70,72495375;-33,47628832;1
2073;94;73;7;80;-70,73891664;-33,47636976;1
2074;119;84;17;101;-70,7331744;-33,47660353;1
2075;82;61;12;73;-70,73253613;-33,47615818;1
2076;509;363;64;427;-70,74685544;-33,47728435;1
2077;99;74;15;89;-70,73546371;-33,47635937;1
2078;56;47;0;47;-70,72877136;-33,47637894;1
2079;84;57;12;69;-70,73175087;-33,47650003;1
2080;38;26;6;32;-70,72993701;-33,47622981;1
2081;63;41;16;57;-70,73069845;-33,47665287;1
2082;63;46;7;53;-70,7368742;-33,47627803;1
2083;119;101;5;106;-70,74991338;-33,47600446;1
2084;71;53;9;62;-70,72511564;-33,47660955;1
2085;90;56;18;74;-70,72725782;-33,47660335;1
2086;89;61;15;76;-70,73419363;-33,47658766;1
2087;39;31;4;35;-70,7384375;-33,47647212;1
2088;42;32;4;36;-70,73800522;-33,47636847;1
2089;151;105;27;132;-70,7418457;-33,47675241;1
2090;74;58;6;64;-70,74812787;-33,47616135;1
2091;65;43;13;56;-70,74533476;-33,47628302;1
2092;82;57;11;68;-70,72816917;-33,47679162;1
2093;66;49;12;61;-70,73269687;-33,47676028;1
2094;98;67;15;82;-70,72538775;-33,47684583;1
2095;35;29;0;29;-70,74625986;-33,47643589;1
2096;49;35;11;46;-70,74423139;-33,47636831;1
2097;54;34;9;43;-70,72934878;-33,4767755;1
2098;57;35;0;35;-70,72994324;-33,47656129;1
2099;117;87;13;100;-70,74993972;-33,47632361;1
2100;51;34;8;42;-70,73218817;-33,47666808;1
2101;74;54;11;65;-70,73677724;-33,47665394;1
2102;52;38;10;48;-70,74005688;-33,47674411;1
2103;79;46;14;60;-70,72850631;-33,47699131;1
2104;93;70;11;81;-70,73347649;-33,47705214;1
2105;122;88;12;100;-70,74816866;-33,47649651;1
2106;25;21;0;21;-70,74356429;-33,47664827;1
2107;12;8;4;12;-70,72652493;-33,47682114;0
2108;34;27;0;27;-70,74316013;-33,4766795;1
2109;94;63;9;72;-70,72565454;-33,47707864;1
2110;30;25;0;25;-70,74276;-33,47668435;1
2111;55;41;10;51;-70,72388293;-33,47703931;1
2112;27;14;0;14;-70,74236173;-33,47671722;0
2113;68;51;11;62;-70,74536951;-33,47662225;1
2114;59;43;5;48;-70,7376427;-33,47683173;1
2115;475;347;56;403;-70,72484708;-33,47879659;1
2116;118;90;14;104;-70,74998446;-33,47664338;1
2117;53;27;9;36;-70,74426702;-33,47670815;1
2118;44;29;8;37;-70,72995029;-33,47689137;1
2119;34;29;0;29;-70,73394407;-33,47706492;1
2120;100;70;16;86;-70,72716617;-33,47727766;1
2121;60;46;10;56;-70,73484924;-33,47715196;1
2122;86;59;11;70;-70,72425753;-33,47730593;1
2123;71;54;0;54;-70,72603839;-33,47721534;1
2124;54;46;0;46;-70,73858762;-33,47700971;1
2125;87;58;15;73;-70,74064694;-33,47717091;1
2126;124;92;15;107;-70,74820057;-33,47683132;1
2127;66;49;5;54;-70,72912901;-33,47724296;1
2128;108;79;15;94;-70,73520239;-33,47745179;1
2129;75;42;19;61;-70,74540792;-33,47696257;1
2130;42;27;8;35;-70,73577835;-33,47739561;1
2131;57;39;0;39;-70,7319555;-33,47714505;1
2132;96;69;4;73;-70,72452533;-33,47754407;1
2133;115;75;18;93;-70,75001972;-33,47696537;1
2134;54;35;13;48;-70,74430437;-33,47704881;1
2135;42;30;5;35;-70,73027805;-33,47720486;1
2136;68;44;14;58;-70,72978276;-33,47752003;1
2137;59;47;0;47;-70,72633068;-33,47746775;1
2138;74;60;7;67;-70,73621293;-33,47751702;1
2139;66;47;8;55;-70,7431628;-33,47712558;1
2140;55;46;0;46;-70,74230513;-33,47736034;1
2141;62;40;12;52;-70,72904012;-33,47763027;1
2142;97;65;20;85;-70,73656567;-33,47778968;1
2143;147;119;7;126;-70,74824247;-33,47716861;1
2144;83;63;8;71;-70,72479493;-33,47777769;1
2145;65;44;11;55;-70,73762659;-33,47749536;1
2146;45;26;13;39;-70,74638713;-33,47743705;1
2147;76;50;12;62;-70,72648859;-33,47779212;1
2148;98;74;9;83;-70,74544918;-33,47732786;1
2149;87;66;9;75;-70,73408166;-33,47761501;1
2150;42;32;0;32;-70,72773282;-33,47768517;1
2151;88;63;9;72;-70,73050671;-33,47751915;1
2152;77;47;13;60;-70,73176534;-33,47774696;1
2153;65;48;0;48;-70,73217875;-33,47770382;1
2154;112;92;7;99;-70,75005696;-33,4773174;1
2155;275;193;40;233;-70,7332458;-33,47778496;1
2156;47;41;0;41;-70,74434557;-33,47741344;1
2157;66;45;11;56;-70,74331744;-33,47749089;1
2158;103;71;15;86;-70,73808159;-33,47798716;1
2159;110;77;12;89;-70,73905505;-33,47791957;1
2160;82;63;9;72;-70,72676094;-33,47802544;1
2161;48;34;9;43;-70,72802388;-33,47789677;1
2162;96;82;0;82;-70,74827445;-33,47750684;1
2163;56;46;5;51;-70,73735172;-33,47785383;1
2164;25;20;0;20;-70,75120676;-33,47755178;0
2165;62;48;7;55;-70,72496212;-33,47809716;1
2166;63;42;10;52;-70,73051478;-33,47784828;1
2167;125;98;10;108;-70,75009586;-33,47763599;1
2168;84;57;14;71;-70,7454965;-33,47774655;1
2169;83;62;0;62;-70,7235537;-33,4785099;1
2170;156;124;17;141;-70,74033229;-33,47808759;1
2171;120;82;0;82;-70,760432;-33,47786505;1
2172;101;75;10;85;-70,72823628;-33,47830258;1
2173;69;56;8;64;-70,7270298;-33,47825748;1
2174;86;50;19;69;-70,74466147;-33,47827111;1
2175;46;34;12;46;-70,74420336;-33,47809437;1
2176;63;48;5;53;-70,73553457;-33,47807094;1
2177;53;36;10;46;-70,74375695;-33,47811086;1
2178;122;95;11;106;-70,7483137;-33,47784024;1
2179;47;31;8;39;-70,74331627;-33,47812587;1
2180;16;11;0;11;-70,74279418;-33,47810865;0
2181;73;50;5;55;-70,72524836;-33,47834572;1
2182;104;82;9;91;-70,73341748;-33,47828993;1
2183;55;30;15;45;-70,73673984;-33,47825375;1
2184;66;51;8;59;-70,7301761;-33,4782668;1
2185;91;65;15;80;-70,72563615;-33,47848523;1
2186;26;21;0;21;-70,75126812;-33,47786861;1
2187;82;65;6;71;-70,72729705;-33,47848628;1
2188;73;61;5;66;-70,73081673;-33,47847185;1
2189;40;25;8;33;-70,74646067;-33,47808333;1
2190;116;89;13;102;-70,75013628;-33,47795188;1
2191;66;45;0;45;-70,75959181;-33,47802223;1
2192;66;51;0;51;-70,73731032;-33,47848108;1
2193;80;58;13;71;-70,73822903;-33,47854161;1
2194;80;61;10;71;-70,7289261;-33,47852249;1
2195;73;51;9;60;-70,74599499;-33,4783934;1
2196;68;46;11;57;-70,74554097;-33,47842286;1
2197;56;40;8;48;-70,73174883;-33,4785049;1
2198;75;50;14;64;-70,74510952;-33,47844173;1
2199;53;33;11;44;-70,73528987;-33,47841909;1
2200;103;84;0;84;-70,72590815;-33,47872377;1
2201;28;17;0;17;-70,74186876;-33,47881203;0
2202;117;83;15;98;-70,7483591;-33,4782157;1
2203;146;112;11;123;-70,72772936;-33,47883953;1
2204;46;34;0;34;-70,75133345;-33,47818767;1
2205;88;61;6;67;-70,72922894;-33,4787367;1
2206;54;45;0;45;-70,75083075;-33,47843589;1
2207;50;44;0;44;-70,75042135;-33,47845222;1
2208;46;34;0;34;-70,75001718;-33,47845798;1
2209;92;73;11;84;-70,73302778;-33,4788841;1
2210;60;48;0;48;-70,73958765;-33,4785022;1
2211;48;33;6;39;-70,7495759;-33,4784855;1
2212;68;56;7;63;-70,73420498;-33,47881775;1
2213;89;65;10;75;-70,72617789;-33,47895361;1
2214;104;75;13;88;-70,7357254;-33,47892048;1
2215;87;65;15;80;-70,72954514;-33,47895917;1
2216;25;21;0;21;-70,73475065;-33,47879785;1
2217;78;57;15;72;-70,72407451;-33,47899496;1
2218;122;93;13;106;-70,74843349;-33,47860733;1
2219;26;20;0;20;-70,73366974;-33,47879432;0
2220;63;42;8;50;-70,73625986;-33,4788901;1
2221;423;295;45;340;-70,73995862;-33,47955003;1
2222;20;16;0;16;-70,7514207;-33,47857484;0
2223;48;38;4;42;-70,73516081;-33,4789277;1
2224;68;50;8;58;-70,73937871;-33,47879107;1
2225;97;69;10;79;-70,74157167;-33,47923459;1
2226;90;61;12;73;-70,72644212;-33,47918563;1
2227;99;64;12;76;-70,72812354;-33,4791799;1
2228;84;60;11;71;-70,74373925;-33,47872889;1
2229;57;38;12;50;-70,7370426;-33,47896072;1
2230;100;77;7;84;-70,72988722;-33,47920608;1
2231;70;59;5;64;-70,72435518;-33,47922915;1
2232;60;46;0;46;-70,75929747;-33,47856248;1
2233;135;105;0;105;-70,76060414;-33,47854943;1
2234;185;130;24;154;-70,73267934;-33,47935955;1
2235;82;51;21;72;-70,72840028;-33,47941638;1
2236;107;81;17;98;-70,73020299;-33,4794279;1
2237;168;120;17;137;-70,72687414;-33,47954114;1
2238;78;68;5;73;-70,73915897;-33,47909436;1
2239;74;53;5;58;-70,72463755;-33,47946858;1
2240;44;32;0;32;-70,73462078;-33,47929789;1
2241;54;42;0;42;-70,73628383;-33,47943771;1
2242;22;19;0;19;-70,72374033;-33,47950183;0
2243;74;59;9;68;-70,73751977;-33,47951165;1
2244;169;130;10;140;-70,7460238;-33,48106751;1
2245;99;75;7;82;-70,73049733;-33,47965415;1
2246;104;76;13;89;-70,72868586;-33,47966385;1
2247;90;57;18;75;-70,73792694;-33,47964795;1
2248;66;53;5;58;-70,7369552;-33,47951845;1
2249;84;63;7;70;-70,72491892;-33,47971457;1
2250;30;20;4;24;-70,73899497;-33,47941872;1
2251;25;20;0;20;-70,74243975;-33,47966739;0
2252;34;28;4;32;-70,73412251;-33,47956013;1
2253;130;98;11;109;-70,73594647;-33,4797634;1
2254;82;64;7;71;-70,74115783;-33,47967927;1
2255;96;71;10;81;-70,72727249;-33,47988211;1
2256;189;133;19;152;-70,74809521;-33,47983695;1
2257;93;72;11;83;-70,72900602;-33,47993614;1
2258;186;139;12;151;-70,74852007;-33,47973631;1
2259;80;68;6;74;-70,73875606;-33,47966284;1
2260;113;87;9;96;-70,74894326;-33,47963757;1
2261;259;192;36;228;-70,75167743;-33,48181337;1
2262;72;59;0;59;-70,74937851;-33,47952835;1
2263;727;544;32;576;-70,75743129;-33,48197432;1
2264;32;26;0;26;-70,73451951;-33,47974781;1
2265;96;76;14;90;-70,7340636;-33,48012627;1
2266;56;39;4;43;-70,7239036;-33,47997861;1
2267;38;0;0;0;-70,73193796;-33,47983773;0
2268;69;51;11;62;-70,73066227;-33,4799772;1
2269;96;69;10;79;-70,72754687;-33,48012274;1
2270;37;20;10;30;-70,74280456;-33,47995403;1
2271;93;67;10;77;-70,72930173;-33,48018068;1
2272;91;69;10;79;-70,74101177;-33,48006947;1
2273;109;76;14;90;-70,73468239;-33,48019199;1
2274;73;51;10;61;-70,73855971;-33,47994539;1
2275;78;57;6;63;-70,72552869;-33,48023026;1
2276;64;47;10;57;-70,72422415;-33,4802984;1
2277;35;27;0;27;-70,73240824;-33,48019634;1
2278;113;87;6;93;-70,72783303;-33,48036919;1
2279;65;42;10;52;-70,73588094;-33,48019065;1
2280;100;65;16;81;-70,72958129;-33,48041934;1
2281;79;58;11;69;-70,74219135;-33,48024299;1
2282;51;43;0;43;-70,73084199;-33,4804151;1
2283;43;32;0;32;-70,73180928;-33,48021423;1
2284;82;51;15;66;-70,77293732;-33,51689938;1
2285;128;85;11;96;-70,78397508;-33,51637454;1
2286;725;544;29;573;-70,79778113;-33,5238327;1
2287;35;25;0;25;-70,76242146;-33,51664801;1
2288;94;65;11;76;-70,78147198;-33,52320584;1
2289;311;208;20;228;-70,79248753;-33,51696978;1
2290;57;46;5;51;-70,78228808;-33,52341178;1
2291;49;32;12;44;-70,77350932;-33,51692285;1
2292;131;97;12;109;-70,78336694;-33,52325489;1
2293;46;30;9;39;-70,78474081;-33,52329921;1
2294;38;21;0;21;-70,76015362;-33,52373824;1
2295;68;39;19;58;-70,77351434;-33,52369455;1
2296;60;42;5;47;-70,78548205;-33,52350989;1
2297;55;38;7;45;-70,78619929;-33,52335471;1
2298;64;40;10;50;-70,76949164;-33,52390759;1
2299;88;72;7;79;-70,78717133;-33,52392989;1
2300;78;56;10;66;-70,76994313;-33,52416541;1
2301;124;77;8;85;-70,7878334;-33,52394363;1
2302;132;92;8;100;-70,78820136;-33,52395655;1
2303;68;53;0;53;-70,78862206;-33,52396458;1
2304;76;59;5;64;-70,78017602;-33,52391368;1
2305;67;48;8;56;-70,77183092;-33,52368776;1
2306;115;80;7;87;-70,78904008;-33,52397279;1
2307;60;46;4;50;-70,78078316;-33,52356322;1
2308;75;53;0;53;-70,78984731;-33,5234454;1
2309;62;53;0;53;-70,78137307;-33,52375942;1
2310;30;20;6;26;-70,77677254;-33,52370795;1
2311;68;56;6;62;-70,78180255;-33,52377023;1
2312;57;41;0;41;-70,79103742;-33,52347601;1
2313;34;25;0;25;-70,77572784;-33,52374627;1
2314;65;52;0;52;-70,78270711;-33,52378817;1
2315;213;155;9;164;-70,79415697;-33,52405469;1
2316;30;27;0;27;-70,78313288;-33,52361979;1
2317;187;139;10;149;-70,79510424;-33,52347982;1
2318;72;50;6;56;-70,79245705;-33,52351249;1
2319;58;37;9;46;-70,78396654;-33,52381812;1
2320;109;77;11;88;-70,79371823;-33,52407063;1
2321;76;52;0;52;-70,78471964;-33,52365965;1
2322;106;92;0;92;-70,79329643;-33,52407695;1
2323;51;42;0;42;-70,79631853;-33,52370841;1
2324;100;73;6;79;-70,76560812;-33,54362949;1
2325;45;27;9;36;-70,77422599;-33,52388613;1
2326;111;79;15;94;-70,78653453;-33,52408678;1
2327;44;28;0;28;-70,75578907;-33,52431574;1
2328;48;27;15;42;-70,75624544;-33,52432047;1
2329;28;18;4;22;-70,7567884;-33,52432611;1
2330;46;18;24;42;-70,7643478;-33,5243947;1
2331;67;43;0;43;-70,77181638;-33,52405799;1
2332;145;112;19;131;-70,75821267;-33,52472551;1
2333;59;47;0;47;-70,7807739;-33,52392467;1
2334;102;62;25;87;-70,76658833;-33,52416271;1
2335;69;47;4;51;-70,7898337;-33,52379823;1
2336;293;181;58;239;-70,75954105;-33,52472793;1
2337;86;60;5;65;-70,79104956;-33,52382767;1
2338;59;47;0;47;-70,78226047;-33,52415351;1
2339;50;33;8;41;-70,76145338;-33,52431602;1
2340;40;29;6;35;-70,76250138;-33,52431277;1
2341;64;49;4;53;-70,78332075;-33,5239856;1
2342;102;82;6;88;-70,79509528;-33,52383512;1
2343;88;71;0;71;-70,79247525;-33,52386061;1
2344;29;23;0;23;-70,78443801;-33,52400963;1
2345;101;63;20;83;-70,77629194;-33,52420324;1
2346;70;53;4;57;-70,78574851;-33,52404882;1
2347;63;39;19;58;-70,77391548;-33,52436429;1
2348;73;47;6;53;-70,7898212;-33,52414979;1
2349;62;49;6;55;-70,77185113;-33,52449025;1
2350;77;47;22;69;-70,7665837;-33,52454033;1
2351;85;65;6;71;-70,78143659;-33,52431117;1
2352;102;70;4;74;-70,79105994;-33,52418133;1
2353;136;93;17;110;-70,78331658;-33,52435946;1
2354;70;52;0;52;-70,79476733;-33,52417782;1
2355;87;63;7;70;-70,79249687;-33,52421547;1
2356;65;42;9;51;-70,79549125;-33,52420725;1
2357;65;45;8;53;-70,78467761;-33,52439657;1
2358;53;36;11;47;-70,76145482;-33,52474328;1
2359;119;77;7;84;-70,79635843;-33,52424293;1
2360;43;28;8;36;-70,76261173;-33,52474174;1
2361;59;49;7;56;-70,78576725;-33,52442422;1
2362;104;67;27;94;-70,7564247;-33,52542207;1
2363;116;88;8;96;-70,79771531;-33,52429298;1
2364;66;48;0;48;-70,78980915;-33,52452304;1
2365;154;108;20;128;-70,77672471;-33,52549348;1
2366;20;13;0;13;-70,7910646;-33,52455271;0
2367;146;92;34;126;-70,77551364;-33,52534709;1
2368;83;55;20;75;-70,76657952;-33,52492352;1
2369;156;106;22;128;-70,77429321;-33,52485394;1
2370;200;136;31;167;-70,77685552;-33,52791281;1
2371;75;61;0;61;-70,7947591;-33,52453288;1
2372;66;45;5;50;-70,79251574;-33,5245866;1
2373;85;62;7;69;-70,77978694;-33,52480373;1
2374;102;81;4;85;-70,79547252;-33,52456135;1
2375;49;0;0;0;-70,7469846;-33,53285394;0
2376;115;90;4;94;-70,79635069;-33,52459598;1
2377;99;77;8;85;-70,78125134;-33,52484131;1
2378;78;54;17;71;-70,77241266;-33,52514577;1
2379;43;27;11;38;-70,76144196;-33,52517423;1
2380;171;121;6;127;-70,79773053;-33,52464685;1
2381;149;111;16;127;-70,78257448;-33,52538569;1
2382;33;23;0;23;-70,76260694;-33,52518082;1
2383;135;86;33;119;-70,77127362;-33,52521709;1
2384;281;220;20;240;-70,78625702;-33,52496323;1
2385;169;102;36;138;-70,76992901;-33,52570506;1
2386;546;356;87;443;-70,76869401;-33,52678164;1
2387;26;20;0;20;-70,77669979;-33,5251264;0
2388;170;107;22;129;-70,78735097;-33,52548486;1
2389;55;36;7;43;-70,77456948;-33,5252148;1
2390;30;20;5;25;-70,77609165;-33,52516766;1
2391;57;46;0;46;-70,78876853;-33,52504236;1
2392;50;43;0;43;-70,77905798;-33,52548942;1
2393;66;53;0;53;-70,77993864;-33,52518479;1
2394;130;89;11;100;-70,78947126;-33,5254317;1
2395;179;126;27;153;-70,76635334;-33,52581768;1
2396;180;140;0;140;-70,79100712;-33,52508506;1
2397;54;37;6;43;-70,78065693;-33,52534052;1
2398;141;102;11;113;-70,77820282;-33,53208096;1
2399;63;46;0;46;-70,78108349;-33,52535743;1
2400;42;33;0;33;-70,78168214;-33,52522741;1
2401;57;35;15;50;-70,76535011;-33,5254729;1
2402;16;12;4;16;-70,75926409;-33,52704052;0
2403;88;58;8;66;-70,79219724;-33,52548378;1
2404;78;59;0;59;-70,79263985;-33,52549885;1
2405;104;78;6;84;-70,79361656;-33,52515426;1
2406;693;481;97;578;-70,7634395;-33,5276304;1
2407;16;10;0;10;-70,76128252;-33,52576002;0
2408;92;64;5;69;-70,79504495;-33,52518781;1
2409;62;45;9;54;-70,78519346;-33,52532275;1
2410;64;49;0;49;-70,76224684;-33,52567427;1
2411;87;66;4;70;-70,79626138;-33,52521285;1
2412;173;128;15;143;-70,78602981;-33,52568984;1
2413;83;64;0;64;-70,79765789;-33,52524621;1
2414;44;24;13;37;-70,77454234;-33,52558598;1
2415;72;48;5;53;-70,78782354;-33,52565649;1
2416;47;34;0;34;-70,77974726;-33,52568533;1
2417;46;32;7;39;-70,77297027;-33,52585144;1
2418;18;10;0;10;-70,76674982;-33,52569529;0
2419;56;45;0;45;-70,78885785;-33,52543176;1
2420;51;38;8;46;-70,78017905;-33,52569625;1
2421;93;63;12;75;-70,77216317;-33,52591109;1
2422;55;37;0;37;-70,78990115;-33,52561767;1
2423;40;29;9;38;-70,76537813;-33,52578298;1
2424;44;34;5;39;-70,78188032;-33,52573836;1
2425;62;47;8;55;-70,77132674;-33,52595895;1
2426;43;32;0;32;-70,79359961;-33,52553458;1
2427;71;59;6;65;-70,7851832;-33,52566051;1
2428;94;66;0;66;-70,79503164;-33,52556765;1
2429;67;48;8;56;-70,76227317;-33,52604803;1
2430;73;55;0;55;-70,79627017;-33,52559435;1
2431;28;18;7;25;-70,76674956;-33,52598527;1
2432;60;39;14;53;-70,77451529;-33,52596237;1
2433;78;60;0;60;-70,7810469;-33,52586235;1
2434;132;104;16;120;-70,77665169;-33,52640441;1
2435;38;30;0;30;-70,7976541;-33,52562702;1
2436;82;60;8;68;-70,79074106;-33,52574746;1
2437;47;29;8;37;-70,76540093;-33,52607337;1
2438;51;37;0;37;-70,78885076;-33,52580863;1
2439;99;68;17;85;-70,76140589;-33,5269638;1
2440;107;75;6;81;-70,79358128;-33,52589895;1
2441;70;49;8;57;-70,78517369;-33,52599552;1
2442;93;66;5;71;-70,79502062;-33,52593133;1
2443;60;46;10;56;-70,76231514;-33,52640906;1
2444;72;55;0;55;-70,79627077;-33,52596006;1
2445;0;0;0;0;-70,76543335;-33,52639898;0
2446;85;70;9;79;-70,77919404;-33,52622032;1
2447;106;71;6;77;-70,79765514;-33,52599194;1
2448;99;70;13;83;-70,7801344;-33,52669598;1
2449;97;70;7;77;-70,78105003;-33,52626304;1
2450;97;69;12;81;-70,77480287;-33,52668115;1
2451;38;27;0;27;-70,77422706;-33,52639912;1
2452;99;71;11;82;-70,78194937;-33,52673302;1
2453;97;66;10;76;-70,78987633;-33,52664276;1
2454;88;57;4;61;-70,79072758;-33,5261716;1
2455;189;129;28;157;-70,77365937;-33,52689599;1
2456;53;41;0;41;-70,78884178;-33,52621808;1
2457;579;435;29;464;-70,78526536;-33,52939836;1
2458;115;83;7;90;-70,79152865;-33,52664619;1
2459;96;75;5;80;-70,78943357;-33,52665883;1
2460;90;61;14;75;-70,77245685;-33,52666862;1
2461;273;191;24;215;-70,78334672;-33,52662336;1
2462;85;58;5;63;-70,78788763;-33,52666433;1
2463;182;117;39;156;-70,76620156;-33,52727974;1
2464;102;73;7;80;-70,79215899;-33,52668623;1
2465;226;178;15;193;-70,78468099;-33,52666083;1
2466;332;240;33;273;-70,77098926;-33,52728093;1
2467;80;54;9;63;-70,78743096;-33,52667643;1
2468;96;73;5;78;-70,79260204;-33,52669921;1
2469;107;75;0;75;-70,79302344;-33,52670516;1
2470;249;189;16;205;-70,78588822;-33,52669937;1
2471;66;53;0;53;-70,7937735;-33,52630386;1
2472;66;49;6;55;-70,77596504;-33,52682001;1
2473;48;29;9;38;-70,7623555;-33,5267708;1
2474;76;61;0;61;-70,79472452;-33,52632652;1
2475;78;59;0;59;-70,78677602;-33,52670684;1
2476;79;55;11;66;-70,77841951;-33,52684562;1
2477;110;75;9;84;-70,79533565;-33,5267417;1
2478;22;12;0;12;-70,76580286;-33,52680393;0
2479;100;79;0;79;-70,79575469;-33,5267503;1
2480;40;33;0;33;-70,77928253;-33,5266675;1
2481;148;101;25;126;-70,76523939;-33,52758251;1
2482;103;71;10;81;-70,7961761;-33,52675756;1
2483;40;34;0;34;-70,77970384;-33,52667637;1
2484;20;8;8;16;-70,76512259;-33,52683309;0
2485;91;67;0;67;-70,79662093;-33,52676622;1
2486;92;69;0;69;-70,79765189;-33,52639319;1
2487;66;54;0;54;-70,78060299;-33,52688573;1
2488;51;39;6;45;-70,78147577;-33,52672582;1
2489;38;27;5;32;-70,77419633;-33,52677268;1
2490;45;32;6;38;-70,78883287;-33,52657982;1
2491;30;18;5;23;-70,76674542;-33,52698165;1
2492;64;45;10;55;-70,76237984;-33,52713409;1
2493;41;32;0;32;-70,79452175;-33,52691674;1
2494;87;58;7;65;-70,79049316;-33,52710167;1
2495;54;39;0;39;-70,79107406;-33,52696269;1
2496;97;79;5;84;-70,79765032;-33,52676582;1
2497;73;57;0;57;-70,78882425;-33,52701574;1
2498;142;102;17;119;-70,77245591;-33,52726661;1
2499;82;66;0;66;-70,77923287;-33,52712618;1
2500;77;60;0;60;-70,78127995;-33,52716536;1
2501;55;41;0;41;-70,79373316;-33,52712832;1
2502;72;49;0;49;-70,79765956;-33,52715493;1
2503;50;41;0;41;-70,76433863;-33,5278087;1
2504;68;55;0;55;-70,76477313;-33,52780649;1
2505;45;33;5;38;-70,7657652;-33,52780842;1
2506;53;32;13;45;-70,76624537;-33,52780696;1
2507;497;373;35;408;-70,77951638;-33,52895365;1
2508;213;148;9;157;-70,78857414;-33,52748527;1
2509;190;113;51;164;-70,76155561;-33,52923961;1
2510;46;35;4;39;-70,77105925;-33,52778388;1
2511;309;210;54;264;-70,76346741;-33,53079633;1
2512;45;33;6;39;-70,77263993;-33,52782152;1
2513;111;89;6;95;-70,77396982;-33,52773028;1
2514;114;69;21;90;-70,76130059;-33,52848578;1
2515;89;65;0;65;-70,7909338;-33,52752132;1
2516;111;79;15;94;-70,77064746;-33,5281429;1
2517;167;122;5;127;-70,79307942;-33,52752836;1
2518;132;94;8;102;-70,79604522;-33,52793262;1
2519;25;21;0;21;-70,76727046;-33,52795962;1
2520;45;36;5;41;-70,77238831;-33,52811108;1
2521;44;34;0;34;-70,77305125;-33,52823635;1
2522;59;47;5;52;-70,77348633;-33,52834363;1
2523;223;145;14;159;-70,78815143;-33,52791039;1
2524;98;71;13;84;-70,77391874;-33,52845194;1
2525;299;205;12;217;-70,78970661;-33,52891268;1
2526;104;76;0;76;-70,79098418;-33,52791433;1
2527;299;211;17;228;-70,79268106;-33,52890272;1
2528;77;53;0;53;-70,79286239;-33,52816093;1
2529;78;49;5;54;-70,79330555;-33,52815887;1
2530;47;36;6;42;-70,77169987;-33,52845316;1
2531;87;59;0;59;-70,79425094;-33,52816801;1
2532;54;43;5;48;-70,76452936;-33,52836817;1
2533;56;41;7;48;-70,76557037;-33,52835833;1
2534;97;72;5;77;-70,77431048;-33,52867034;1
2535;81;54;0;54;-70,79478723;-33,52819345;1
2536;75;49;0;49;-70,7952918;-33,52819473;1
2537;113;79;16;95;-70,76726135;-33,52891775;1
2538;54;39;0;39;-70,79756297;-33,52803468;1
2539;113;76;14;90;-70,76771419;-33,52894308;1
2540;93;67;11;78;-70,76817498;-33,52894494;1
2541;57;42;6;48;-70,76870769;-33,52866239;1
2542;40;31;0;31;-70,76931239;-33,52848575;1
2543;100;76;11;87;-70,76336463;-33,52892716;1
2544;61;44;4;48;-70,77207086;-33,52867098;1
2545;82;66;0;66;-70,77465403;-33,52887575;1
2546;56;36;0;36;-70,78807531;-33,52854766;1
2547;160;100;6;106;-70,78894636;-33,5287471;1
2548;66;42;0;42;-70,790468;-33,52855677;1
2549;65;40;0;40;-70,79091856;-33,52855283;1
2550;88;59;0;59;-70,7919127;-33,52875654;1
2551;63;50;7;57;-70,76439527;-33,52872977;1
2552;25;18;4;22;-70,76942981;-33,52917404;1
2553;76;56;8;64;-70,76557153;-33,52872395;1
2554;114;93;11;104;-70,77499461;-33,52908108;1
2555;101;78;5;83;-70,77225613;-33,52914039;1
2556;73;51;0;51;-70,79790957;-33,52848537;1
2557;117;77;13;90;-70,77533644;-33,52928718;1
2558;103;82;12;94;-70,77262361;-33,5293374;1
2559;110;85;9;94;-70,76426558;-33,52909;1
2560;86;62;13;75;-70,76556941;-33,5290841;1
2561;63;44;11;55;-70,76656115;-33,52908431;1
2562;78;58;9;67;-70,77571265;-33,52951579;1
2563;111;88;8;96;-70,77297417;-33,52954559;1
2564;137;97;9;106;-70,79378298;-33,52883477;1
2565;220;154;7;161;-70,79612981;-33,52923712;1
2566;142;102;19;121;-70,76977746;-33,52993996;1
2567;168;116;10;126;-70,79630575;-33,52885101;1
2568;60;49;0;49;-70,79801243;-33,52886206;1
2569;107;89;13;102;-70,76413316;-33,52945495;1
2570;81;58;13;71;-70,76557011;-33,52945075;1
2571;52;41;7;48;-70,76655972;-33,52945066;1
2572;105;64;6;70;-70,79106943;-33,52919404;1
2573;53;42;0;42;-70,79812495;-33,5292507;1
2574;112;80;6;86;-70,77044746;-33,53010284;1
2575;11;9;0;9;-70,76351191;-33,52986372;0
2576;37;24;0;24;-70,76392905;-33,53006822;1
2577;71;56;8;64;-70,76434563;-33,53027168;1
2578;129;101;13;114;-70,76476712;-33,53047807;1
2579;60;41;13;54;-70,76556843;-33,52985872;1
2580;101;85;0;85;-70,77404109;-33,53019146;1
2581;62;46;9;55;-70,77177973;-33,5300434;1
2582;78;52;16;68;-70,76725956;-33,53021969;1
2583;122;86;10;96;-70,76771079;-33,53022072;1
2584;311;197;8;205;-70,78885929;-33,5310709;1
2585;85;69;7;76;-70,76817265;-33,53021958;1
2586;62;36;0;36;-70,78869881;-33,52958907;1
2587;32;24;0;24;-70,76881746;-33,52987875;1
2588;76;51;0;51;-70,79119378;-33,52959008;1
2589;45;34;0;34;-70,79230425;-33,52977252;1
2590;234;161;8;169;-70,79342714;-33,53117349;1
2591;42;31;5;36;-70,77310958;-33,53006504;1
2592;112;83;0;83;-70,79346842;-33,53003169;1
2593;99;67;0;67;-70,79395461;-33,52997615;1
2594;85;51;6;57;-70,79439472;-33,52992038;1
2595;76;51;0;51;-70,79482506;-33,52986647;1
2596;187;130;9;139;-70,79565345;-33,53045429;1
2597;46;38;0;38;-70,78135359;-33,52993187;1
2598;130;83;11;94;-70,79593404;-33,53011103;1
2599;98;74;12;86;-70,77438358;-33,53039318;1
2600;39;28;6;34;-70,78086077;-33,52996241;1
2601;84;55;0;55;-70,79682958;-33,5300146;1
2602;104;75;0;75;-70,7963976;-33,5300618;1
2603;128;84;5;89;-70,79737526;-33,52995623;1
2604;104;85;8;93;-70,78339903;-33,52985261;1
2605;71;51;0;51;-70,79810857;-33,52995002;1
2606;67;46;0;46;-70,7985708;-33,52987112;1
2607;76;57;0;57;-70,7713957;-33,53035246;1
2608;73;59;6;65;-70,77758929;-33,53031659;1
2609;63;47;9;56;-70,76556374;-33,53021974;1
2610;44;33;0;33;-70,77345314;-33,5302746;1
2611;76;53;8;61;-70,7823022;-33,53033234;1
2612;50;39;5;44;-70,76655455;-33,5302256;1
2613;90;72;7;79;-70,78185799;-33,53036594;1
2614;44;28;9;37;-70,76901261;-33,53023744;1
2615;96;77;9;86;-70,7747618;-33,53062245;1
2616;105;70;0;70;-70,7913097;-33,52995613;1
2617;148;120;7;127;-70,78353286;-33,53020962;1
2618;92;67;9;76;-70,77107868;-33,53062338;1
2619;58;43;0;43;-70,77225708;-33,5305898;1
2620;75;61;6;67;-70,76555788;-33,53057564;1
2621;77;59;13;72;-70,76632959;-33,53094098;1
2622;79;56;7;63;-70,76676612;-33,53094413;1
2623;51;43;0;43;-70,78117129;-33,53040911;1
2624;82;61;9;70;-70,76919678;-33,53059355;1
2625;68;55;6;61;-70,77260629;-33,53081769;1
2626;66;53;0;53;-70,78049249;-33,53066472;1
2627;89;62;13;75;-70,77076106;-33,53088871;1
2628;33;25;0;25;-70,79032801;-33,53044085;1
2629;48;33;0;33;-70,79097498;-33,53033726;1
2630;52;37;6;43;-70,7800642;-33,53069308;1
2631;40;29;0;29;-70,79163601;-33,530478;1
2632;27;23;0;23;-70,79255672;-33,53043775;1
2633;26;18;0;18;-70,79207282;-33,53047708;0
2634;160;118;14;132;-70,7836;-33,5305699;1
2635;56;46;0;46;-70,77924307;-33,53078034;1
2636;75;59;4;63;-70,77607165;-33,53142985;1
2637;88;60;0;60;-70,79463198;-33,53056895;1
2638;42;36;0;36;-70,77876659;-33,53083676;1
2639;71;56;0;56;-70,77299613;-33,5310697;1
2640;39;21;0;21;-70,7655659;-33,53093421;1
2641;50;39;0;39;-70,78124125;-33,53076561;1
2642;94;65;13;78;-70,76772139;-33,53094002;1
2643;52;40;0;40;-70,77025194;-33,53106598;1
2644;73;50;7;57;-70,76910703;-33,53093812;1
2645;119;85;0;85;-70,79719821;-33,53074734;1
2646;55;42;6;48;-70,77156536;-33,53120215;1
2647;43;33;0;33;-70,79103662;-33,53071607;1
2648;66;50;8;58;-70,77337016;-33,53131212;1
2649;55;39;0;39;-70,78431759;-33,5309155;1
2650;38;28;0;28;-70,79382077;-33,53096271;1
2651;103;79;12;91;-70,78328954;-33,53099295;1
2652;73;52;4;56;-70,76995024;-33,53132448;1
2653;77;59;6;65;-70,76556294;-33,53129882;1
2654;126;90;15;105;-70,78175169;-33,53111638;1
2655;40;24;0;24;-70,79234009;-33,53136767;1
2656;99;71;17;88;-70,7677195;-33,5313014;1
2657;50;35;7;42;-70,77190554;-33,53143583;1
2658;29;21;0;21;-70,76888793;-33,53129222;1
2659;79;56;15;71;-70,77380698;-33,53160836;1
2660;51;35;0;35;-70,79046402;-33,53118721;1
2661;47;32;6;38;-70,78068672;-33,53139389;1
2662;67;54;0;54;-70,77058807;-33,53153067;1
2663;44;36;0;36;-70,78020478;-33,53141451;1
2664;61;51;0;51;-70,7696451;-33,53158367;1
2665;55;44;0;44;-70,77973889;-33,53144885;1
2666;54;46;5;51;-70,77930924;-33,53148635;1
2667;56;41;4;45;-70,78438494;-33,53127152;1
2668;184;151;11;162;-70,77815668;-33,53171854;1
2669;108;75;4;79;-70,79490402;-33,53128717;1
2670;95;77;0;77;-70,78332875;-33,53135184;1
2671;131;99;10;109;-70,77289353;-33,5318744;1
2672;63;51;0;51;-70,77092456;-33,53175998;1
2673;117;86;10;96;-70,78181965;-33,53147254;1
2674;118;84;16;100;-70,76599684;-33,53170292;1
2675;98;78;8;86;-70,76771798;-33,53170452;1
2676;50;36;0;36;-70,79711885;-33,53146004;1
2677;47;38;0;38;-70,79113977;-33,53143718;1
2678;125;97;4;101;-70,77260561;-33,53215837;1
2679;55;44;6;50;-70,78444787;-33,53161833;1
2680;47;33;10;43;-70,77126748;-33,5319958;1
2681;86;58;19;77;-70,78336713;-33,53170071;1
2682;74;53;11;64;-70,76984919;-33,53218613;1
2683;107;87;0;87;-70,78187897;-33,53182202;1
2684;106;84;11;95;-70,76604981;-33,5320525;1
2685;40;29;0;29;-70,79614483;-33,53169222;1
2686;81;61;11;72;-70,76768859;-33,53205528;1
2687;148;109;16;125;-70,78008983;-33,53195511;1
2688;50;30;0;30;-70,79723937;-33,5317801;1
2689;88;66;8;74;-70,77018979;-33,53241412;1
2690;114;91;12;103;-70,77228164;-33,53246087;1
2691;290;178;61;239;-70,74849222;-33,51225528;1
2692;61;41;0;41;-70,7845115;-33,53196754;1
2693;33;19;9;28;-70,74767731;-33,51130809;1
2694;120;79;9;88;-70,78058501;-33,51655567;1
2695;50;39;0;39;-70,77427447;-33,54360714;1
2696;69;44;6;50;-70,78169336;-33,51102381;1
2697;82;47;16;63;-70,74127062;-33,51147214;1
2698;123;76;12;88;-70,78814058;-33,51085748;1
2699;24;17;0;17;-70,79373326;-33,51097555;0
2700;331;221;36;257;-70,78945628;-33,51082843;1
2701;266;174;20;194;-70,78566521;-33,51086935;1
2702;168;133;6;139;-70,7978527;-33,51077672;1
2703;90;58;10;68;-70,78770948;-33,51090403;1
2704;20;14;0;14;-70,7799937;-33,51092633;0
2705;108;79;7;86;-70,78727592;-33,51095094;1
2706;81;57;0;57;-70,78683732;-33,51099809;1
2707;107;80;5;85;-70,78103341;-33,51114616;1
2708;582;412;36;448;-70,79719266;-33,51113196;1
2709;52;38;9;47;-70,77322194;-33,51140384;1
2710;86;58;10;68;-70,82595249;-33,51079813;1
2711;59;39;10;49;-70,75541586;-33,51198488;1
2712;137;99;24;123;-70,77952479;-33,51124415;1
2713;74;47;13;60;-70,77022078;-33,51138862;1
2714;71;50;8;58;-70,77745988;-33,51115046;1
2715;175;118;27;145;-70,76790238;-33,51288139;1
2716;121;86;9;95;-70,78413795;-33,51108883;1
2717;17;0;0;0;-70,7758202;-33,51127538;0
2718;46;30;12;42;-70,77082309;-33,51141195;1
2719;19;14;0;14;-70,77635481;-33,51129965;0
2720;70;43;13;56;-70,74882501;-33,5117694;1
2721;1106;770;66;836;-70,79516159;-33,5118235;1
2722;37;26;5;31;-70,77685915;-33,51133255;1
2723;184;117;18;135;-70,78239541;-33,51164237;1
2724;129;96;10;106;-70,78323011;-33,51119107;1
2725;94;70;5;75;-70,78625327;-33,51117132;1
2726;64;36;14;50;-70,74758788;-33,51192782;1
2727;87;58;12;70;-70,79017003;-33,51115868;1
2728;70;67;0;67;-70,79112795;-33,51135113;1
2729;49;34;9;43;-70,77381566;-33,51152779;1
2730;163;107;10;117;-70,78536068;-33,51126471;1
2731;68;39;12;51;-70,82752004;-33,51089593;1
2732;73;54;0;54;-70,82674753;-33,51092352;1
2733;184;125;14;139;-70,78960356;-33,51147235;1
2734;97;64;15;79;-70,74151847;-33,51192881;1
2735;69;58;5;63;-70,791746;-33,51140512;1
2736;164;116;7;123;-70,78916843;-33,51151778;1
2737;79;61;0;61;-70,79214787;-33,51143813;1
2738;48;24;16;40;-70,77232537;-33,51158744;1
2739;35;23;7;30;-70,77749734;-33,51148171;1
2740;79;53;7;60;-70,79254953;-33,51147749;1
2741;100;73;0;73;-70,78419517;-33,51144508;1
2742;164;113;11;124;-70,78792214;-33,51139852;1
2743;71;58;0;58;-70,79294631;-33,51151339;1
2744;85;63;11;74;-70,7936289;-33,51137044;1
2745;165;117;6;123;-70,78328948;-33,51154865;1
2746;113;74;7;81;-70,78705346;-33,51149123;1
2747;30;21;6;27;-70,75819907;-33,51210494;1
2748;63;44;4;48;-70,78105013;-33,51167144;1
2749;15;0;0;0;-70,75911511;-33,51215515;0
2750;176;121;14;135;-70,78648271;-33,51181031;1
2751;30;12;15;27;-70,759602;-33,51220789;1
2752;68;52;0;52;-70,79426352;-33,51167888;1
2753;104;80;5;85;-70,7902103;-33,511521;1
2754;58;41;10;51;-70,77597312;-33,51175338;1
2755;84;36;40;76;-70,76933474;-33,51215032;1
2756;171;117;35;152;-70,76163994;-33,51236776;1
2757;33;19;0;19;-70,74686916;-33,51221333;0
2758;119;81;17;98;-70,78045059;-33,51187424;1
2759;325;232;19;251;-70,79656164;-33,51197961;1
2760;62;41;11;52;-70,77683193;-33,51179177;1
2761;118;70;41;111;-70,75371049;-33,51281054;1
2762;81;63;7;70;-70,77995463;-33,51189465;1
2763;87;57;17;74;-70,74208824;-33,51254231;1
2764;118;82;12;94;-70,77943932;-33,5119821;1
2765;47;29;8;37;-70,74154063;-33,51250839;1
2766;27;19;5;24;-70,76987287;-33,51222873;1
2767;50;27;8;35;-70,77754892;-33,51183099;1
2768;102;63;28;91;-70,77062304;-33,51245039;1
2769;62;46;13;59;-70,74359385;-33,51287562;1
2770;153;112;13;125;-70,78418395;-33,51181492;1
2771;145;99;7;106;-70,78797546;-33,5117634;1
2772;0;0;0;0;-70,77849993;-33,51360228;0
2773;51;31;14;45;-70,77196594;-33,5125026;1
2774;72;40;15;55;-70,77230723;-33,51205888;1
2775;73;51;0;51;-70,79356539;-33,51174075;1
2776;24;14;7;21;-70,75486003;-33,51241644;1
2777;480;330;26;356;-70,7972125;-33,51223182;1
2778;105;64;11;75;-70,78710738;-33,51185588;1
2779;59;42;5;47;-70,7730592;-33,51232718;1
2780;62;44;5;49;-70,77343445;-33,51234126;1
2781;64;47;0;47;-70,77383761;-33,51235897;1
2782;89;61;9;70;-70,79025947;-33,51187788;1
2783;20;0;0;0;-70,78241021;-33,51199571;0
2784;64;46;0;46;-70,77424276;-33,51237415;1
2785;261;172;16;188;-70,79173951;-33,51223778;1
2786;81;66;9;75;-70,77462608;-33,51239452;1
2787;34;21;6;27;-70,77513397;-33,51241643;1
2788;155;104;19;123;-70,7813247;-33,51208477;1
2789;20;13;0;13;-70,77585661;-33,51244144;0
2790;58;39;12;51;-70,77648457;-33,51248009;1
2791;39;26;6;32;-70,74689765;-33,51268136;1
2792;53;32;15;47;-70,77711513;-33,51253482;1
2793;51;28;8;36;-70,77762022;-33,51244769;1
2794;140;92;7;99;-70,78430363;-33,51216794;1
2795;115;73;6;79;-70,78835065;-33,51220194;1
2796;96;71;0;71;-70,78971706;-33,51219648;1
2797;134;81;14;95;-70,78792028;-33,51224832;1
2798;115;87;8;95;-70,78928054;-33,51224737;1
2799;461;312;19;331;-70,79776896;-33,51266304;1
2800;544;350;101;451;-70,76004318;-33,51416366;1
2801;118;84;11;95;-70,82529916;-33,51176366;1
2802;184;132;7;139;-70,78751956;-33,51250049;1
2803;132;88;7;95;-70,82709669;-33,51174045;1
2804;93;58;8;66;-70,78884659;-33,51229291;1
2805;183;125;10;135;-70,78707628;-33,51250764;1
2806;115;83;5;88;-70,79030267;-33,51224714;1
2807;132;100;0;100;-70,7824311;-33,5123566;1
2808;37;22;0;22;-70,74888268;-33,5128193;1
2809;83;62;13;75;-70,7637662;-33,51303544;1
2810;142;97;17;114;-70,78021026;-33,5124118;1
2811;172;124;15;139;-70,78131324;-33,51244533;1
2812;65;43;18;61;-70,76420395;-33,51305378;1
2813;61;42;13;55;-70,75933052;-33,51286771;1
2814;117;78;13;91;-70,78660644;-33,51258632;1
2815;99;66;7;73;-70,77942236;-33,51264068;1
2816;50;32;14;46;-70,76461886;-33,51305424;1
2817;134;86;13;99;-70,7843603;-33,51252669;1
2818;42;22;9;31;-70,75513255;-33,51293852;1
2819;59;45;10;55;-70,76503841;-33,51306218;1
2820;140;96;10;106;-70,78345648;-33,51262618;1
2821;49;34;10;44;-70,76546212;-33,51307305;1
2822;42;25;10;35;-70,74777822;-33,51315017;1
2823;1131;771;137;908;-70,76131202;-33,51379981;1
2824;46;34;0;34;-70,76588454;-33,51307636;1
2825;124;85;20;105;-70,78244826;-33,51272705;1
2826;123;87;0;87;-70,79277618;-33,51277105;1
2827;131;90;22;112;-70,76958292;-33,51296209;1
2828;150;108;7;115;-70,790454;-33,51280568;1
2829;149;103;11;114;-70,78019808;-33,51277815;1
2830;56;38;9;47;-70,76652772;-33,51308956;1
2831;119;76;7;83;-70,78998647;-33,51281993;1
2832;173;132;15;147;-70,78129749;-33,51280891;1
2833;84;61;8;69;-70,78800457;-33,51277996;1
2834;107;74;4;78;-70,78954726;-33,51282582;1
2835;37;20;12;32;-70,77131098;-33,51317336;1
2836;25;13;7;20;-70,77191997;-33,51301284;0
2837;106;76;9;85;-70,7889975;-33,51283399;1
2838;164;109;33;142;-70,75271921;-33,51356013;1
2839;76;51;15;66;-70,75959044;-33,5134089;1
2840;49;37;7;44;-70,77325989;-33,51312412;1
2841;95;68;11;79;-70,79471778;-33,51333092;1
2842;125;78;9;87;-70,82710082;-33,51239865;1
2843;115;77;16;93;-70,82552081;-33,51243456;1
2844;482;338;22;360;-70,78403389;-33,5133622;1
2845;34;20;8;28;-70,77402406;-33,51315311;1
2846;137;83;34;117;-70,75522714;-33,51335721;1
2847;116;84;11;95;-70,78396124;-33,51296962;1
2848;90;54;14;68;-70,77465741;-33,51342941;1
2849;21;13;0;13;-70,77518402;-33,51344655;0
2850;80;47;20;67;-70,77592855;-33,51330716;1
2851;208;144;15;159;-70,78249502;-33,51322938;1
2852;58;33;14;47;-70,77667768;-33,51333105;1
2853;143;80;48;128;-70,74820125;-33,51415505;1
2854;159;87;34;121;-70,77666668;-33,51393408;1
2855;65;43;15;58;-70,74709981;-33,5139308;1
2856;309;210;32;242;-70,78054212;-33,51317936;1
2857;134;83;23;106;-70,74630167;-33,51395;1
2858;29;15;9;24;-70,74593913;-33,5137629;1
2859;85;51;16;67;-70,74554468;-33,51378112;1
2860;95;59;14;73;-70,74515837;-33,51398422;1
2861;126;85;19;104;-70,74467886;-33,51398845;1
2862;80;50;10;60;-70,74430372;-33,51400713;1
2863;111;76;12;88;-70,74268742;-33,51369902;1
2864;130;90;15;105;-70,7439876;-33,51401054;1
2865;116;72;17;89;-70,74358862;-33,51402177;1
2866;56;32;22;54;-70,75645585;-33,51370206;1
2867;63;48;0;48;-70,78649424;-33,51314639;1
2868;207;140;18;158;-70,78599651;-33,51385589;1
2869;229;165;18;183;-70,78784263;-33,51324933;1
2870;88;48;21;69;-70,7700189;-33,51358716;1
2871;35;18;9;27;-70,77204795;-33,51360337;1
2872;176;128;27;155;-70,76540779;-33,51449013;1
2873;17;9;4;13;-70,75223614;-33,51385432;0
2874;65;49;10;59;-70,74963206;-33,51398277;1
2875;20;0;0;0;-70,72802211;-33,52139641;0
2876;240;162;16;178;-70,78975492;-33,51336649;1
2877;62;36;23;59;-70,75120195;-33,51401968;1
2878;48;36;0;36;-70,7793945;-33,51359431;1
2879;48;35;7;42;-70,77322687;-33,51364597;1
2880;85;64;6;70;-70,78019543;-33,51348875;1
2881;34;23;7;30;-70,77398283;-33,51367447;1
2882;91;50;13;63;-70,74284341;-33,51405465;1
2883;138;93;14;107;-70,78545368;-33,51370807;1
2884;35;23;7;30;-70,78091507;-33,51367235;1
2885;46;37;4;41;-70,78127688;-33,51369029;1
2886;45;37;0;37;-70,7863736;-33,51361938;1
2887;68;44;9;53;-70,78165401;-33,51370685;1
2888;34;24;6;30;-70,7714397;-33,51375926;1
2889;101;70;14;84;-70,82602424;-33,51345381;1
2890;68;49;0;49;-70,82735906;-33,51319805;1
2891;46;31;0;31;-70,82669552;-33,51322081;1
2892;25;19;0;19;-70,78678958;-33,51360782;0
2893;51;37;0;37;-70,79188946;-33,51353902;1
2894;148;113;7;120;-70,78792833;-33,51361858;1
2895;53;45;0;45;-70,79315149;-33,51361921;1
2896;107;78;4;82;-70,78229587;-33,51374243;1
2897;42;26;0;26;-70,74596398;-33,51427574;1
2898;77;0;0;0;-70,7835307;-33,51374356;0
2899;71;44;16;60;-70,78017796;-33,5137843;1
2900;101;70;6;76;-70,78295684;-33,51390742;1
2901;202;130;18;148;-70,7844647;-33,51377096;1
2902;143;115;10;125;-70,7898461;-33,51371518;1
2903;329;199;83;282;-70,75197477;-33,51510216;1
2904;52;35;10;45;-70,75644497;-33,51420509;1
2905;200;123;58;181;-70,75372098;-33,51545599;1
2906;554;400;38;438;-70,79416073;-33,51482712;1
2907;112;82;16;98;-70,75864721;-33,51469858;1
2908;77;49;16;65;-70,75377563;-33,51458519;1
2909;44;32;8;40;-70,75421629;-33,51447371;1
2910;50;30;0;30;-70,7429994;-33,51438422;1
2911;88;58;17;75;-70,75500245;-33,51484809;1
2912;99;67;21;88;-70,76999428;-33,5142286;1
2913;76;48;18;66;-70,75541648;-33,51486384;1
2914;59;39;16;55;-70,77126396;-33,51453748;1
2915;52;29;12;41;-70,77306249;-33,51431709;1
2916;154;101;13;114;-70,78798801;-33,51394986;1
2917;34;20;0;20;-70,77173783;-33,51436009;0
2918;30;18;8;26;-70,77372151;-33,51419225;1
2919;90;67;0;67;-70,79150718;-33,51415861;1
2920;37;29;0;29;-70,77234442;-33,51419915;1
2921;87;54;15;69;-70,77430128;-33,51460667;1
2922;61;46;7;53;-70,79196159;-33,51418984;1
2923;62;44;9;53;-70,77472629;-33,51463852;1
2924;0;0;0;0;-70,77937818;-33,51422053;0
2925;56;44;0;44;-70,7751587;-33,5146366;1
2926;46;37;0;37;-70,79235705;-33,51421395;1
2927;50;34;7;41;-70,78665451;-33,51404152;1
2928;48;35;0;35;-70,77978118;-33,51424568;1
2929;114;87;9;96;-70,78232231;-33,51410653;1
2930;59;31;16;47;-70,75088873;-33,51476145;1
2931;185;125;12;137;-70,78990475;-33,51404461;1
2932;46;28;9;37;-70,78014399;-33,51426171;1
2933;98;82;0;82;-70,79275672;-33,51423711;1
2934;81;53;9;62;-70,78359771;-33,5141023;1
2935;35;23;8;31;-70,75643749;-33,51455206;1
2936;62;37;16;53;-70,74946335;-33,51503875;1
2937;72;40;24;64;-70,74839884;-33,51486054;1
2938;145;100;18;118;-70,78453146;-33,51413059;1
2939;77;56;7;63;-70,79316052;-33,51426137;1
2940;55;35;15;50;-70,74782921;-33,51487528;1
2941;69;47;10;57;-70,74715506;-33,5148899;1
2942;63;46;4;50;-70,78127418;-33,51416933;1
2943;233;154;35;189;-70,74654747;-33,51533386;1
2944;60;40;11;51;-70,74599581;-33,51483402;1
2945;92;71;0;71;-70,79355725;-33,51428317;1
2946;167;108;20;128;-70,74559589;-33,51536473;1
2947;171;126;12;138;-70,74520529;-33,51535172;1
2948;314;217;27;244;-70,74461888;-33,51534928;1
2949;218;134;20;154;-70,74406049;-33,51517379;1
2950;77;49;14;63;-70,74365359;-33,51497454;1
2951;17;15;0;15;-70,74320721;-33,51476825;0
2952;83;52;18;70;-70,77666909;-33,51448512;1
2953;109;78;11;89;-70,78558281;-33,51438345;1
2954;122;89;13;102;-70,78805036;-33,51428335;1
2955;82;56;11;67;-70,76059876;-33,51506327;1
2956;35;20;12;32;-70,75301264;-33,51477257;1
2957;60;37;9;46;-70,75233972;-33,51478224;1
2958;61;42;6;48;-70,78671288;-33,51436808;1
2959;78;53;0;53;-70,78276847;-33,51453393;1
2960;44;28;7;35;-70,77246993;-33,51479203;1
2961;158;115;11;126;-70,789975;-33,51437962;1
2962;87;61;0;61;-70,78208096;-33,51456363;1
2963;80;55;7;62;-70,78125153;-33,51446879;1
2964;60;37;20;57;-70,75644326;-33,51493706;1
2965;183;136;10;146;-70,78459625;-33,51449384;1
2966;97;55;30;85;-70,76997455;-33,51482003;1
2967;67;46;9;55;-70,82705224;-33,51400432;1
2968;150;101;27;128;-70,76224522;-33,5154734;1
2969;126;83;9;92;-70,77990812;-33,51470024;1
2970;34;24;0;24;-70,76177361;-33,51512469;1
2971;154;117;13;130;-70,78812587;-33,51464969;1
2972;101;60;17;77;-70,77339123;-33,51496562;1
2973;63;43;6;49;-70,78677501;-33,5147208;1
2974;27;18;4;22;-70,77186105;-33,51495591;1
2975;50;31;13;44;-70,75436496;-33,51535901;1
2976;132;96;9;105;-70,78937229;-33,51521397;1
2977;629;437;64;501;-70,75934712;-33,51596317;1
2978;99;63;15;78;-70,74602703;-33,51566519;1
2979;46;31;7;38;-70,7760663;-33,51503187;1
2980;121;80;5;85;-70,79559504;-33,5151083;1
2981;133;95;12;107;-70,78977604;-33,51523242;1
2982;168;113;9;122;-70,7862429;-33,51519553;1
2983;207;131;23;154;-70,78318912;-33,51514789;1
2984;151;115;11;126;-70,79017964;-33,51525784;1
2985;198;139;12;151;-70,78367289;-33,51516491;1
2986;82;59;17;76;-70,76296263;-33,51532379;1
2987;23;14;4;18;-70,77725497;-33,51507619;0
2988;162;127;7;134;-70,79057879;-33,51527319;1
2989;170;124;10;134;-70,78411695;-33,51517735;1
2990;0;0;0;0;-70,79094745;-33,51529744;0
2991;136;89;10;99;-70,78570314;-33,5150101;1
2992;200;139;19;158;-70,78456084;-33,51519286;1
2993;203;128;15;143;-70,78505532;-33,5152056;1
2994;59;43;0;43;-70,79167131;-33,5148351;1
2995;72;52;9;61;-70,77939783;-33,51514855;1
2996;47;21;16;37;-70,75062137;-33,51565194;1
2997;28;17;0;17;-70,75598881;-33,51536438;0
2998;91;55;28;83;-70,75005573;-33,51587163;1
2999;85;53;9;62;-70,7484453;-33,51569377;1
3000;38;18;16;34;-70,74787559;-33,51570587;1
3001;58;44;6;50;-70,77979862;-33,51517279;1
3002;45;28;11;39;-70,74720161;-33,51572384;1
3003;155;95;36;131;-70,76804145;-33,51554544;1
3004;53;31;11;42;-70,78013856;-33,51518834;1
3005;143;105;9;114;-70,79236682;-33,51541109;1
3006;124;86;12;98;-70,78238756;-33,51503733;1
3007;123;100;7;107;-70,78818406;-33,51497947;1
3008;45;29;6;35;-70,78047574;-33,51519875;1
3009;45;26;12;38;-70,75309954;-33,51544762;1
3010;116;92;7;99;-70,79276737;-33,51542731;1
3011;55;40;7;47;-70,78082354;-33,51521133;1
3012;46;27;11;38;-70,75236552;-33,51546863;1
3013;111;84;7;91;-70,79316542;-33,5154538;1
3014;50;40;6;46;-70,78119219;-33,51522725;1
3015;66;43;16;59;-70,76923342;-33,51557755;1
3016;69;53;0;53;-70,78684512;-33,51504723;1
3017;126;86;27;113;-70,76400767;-33,51591069;1
3018;127;99;6;105;-70,79356082;-33,51547324;1
3019;41;30;0;30;-70,78157954;-33,51524794;1
3020;70;47;7;54;-70,7702084;-33,51536131;1
3021;64;36;20;56;-70,77155509;-33,51540642;1
3022;81;51;16;67;-70,77239151;-33,51572351;1
3023;73;49;12;61;-70,7564244;-33,51591046;1
3024;66;36;22;58;-70,77299245;-33,5157576;1
3025;130;74;36;110;-70,77435069;-33,51551173;1
3026;84;59;16;75;-70,7651808;-33,51575605;1
3027;63;43;0;43;-70,79170072;-33,51518623;1
3028;160;113;5;118;-70,78825115;-33,51531147;1
3029;198;134;20;154;-70,78242545;-33,51540989;1
3030;19;15;4;19;-70,7757145;-33,51588283;0
3031;28;16;8;24;-70,75518997;-33,51579068;1
3032;60;44;0;44;-70,78714478;-33,51548272;1
3033;55;32;14;46;-70,77626592;-33,51590892;1
3034;90;53;23;76;-70,77690006;-33,51593404;1
3035;40;32;0;32;-70,78673833;-33,51549659;1
3036;87;59;16;75;-70,77754555;-33,51597902;1
3037;35;24;0;24;-70,7858005;-33,51551016;1
3038;91;69;12;81;-70,76143788;-33,51634504;1
3039;114;75;20;95;-70,77020083;-33,51585944;1
3040;94;62;13;75;-70,76184523;-33,51642981;1
3041;154;103;30;133;-70,76569592;-33,51671568;1
3042;62;38;19;57;-70,77155111;-33,51592097;1
3043;230;172;8;180;-70,77949523;-33,51613198;1
3044;75;60;4;64;-70,79173691;-33,51553559;1
3045;233;168;20;188;-70,78007369;-33,51616235;1
3046;121;86;6;92;-70,79532235;-33,51609578;1
3047;61;44;8;52;-70,76240885;-33,5160373;1
3048;154;112;10;122;-70,78832329;-33,51565825;1
3049;151;105;9;114;-70,78061862;-33,51591078;1
3050;141;104;9;113;-70,78114735;-33,51592934;1
3051;205;159;16;175;-70,78166675;-33,51625595;1
3052;47;25;12;37;-70,7735738;-33,51602011;1
3053;651;440;94;534;-70,75336639;-33,51666401;1
3054;124;92;8;100;-70,78222664;-33,51597307;1
3055;26;18;0;18;-70,77429235;-33,51605419;0
3056;128;103;7;110;-70,78282672;-33,5159949;1
3057;40;21;10;31;-70,77505283;-33,5160907;1
3058;345;202;83;285;-70,7494451;-33,51671878;1
3059;243;153;37;190;-70,74893005;-33,51673166;1
3060;237;137;46;183;-70,7484051;-33,5167466;1
3061;269;187;26;213;-70,78335764;-33,51630199;1
3062;114;85;6;91;-70,76323811;-33,5171988;1
3063;106;66;25;91;-70,74648586;-33,51713183;1
3064;74;48;16;64;-70,74716355;-33,51686753;1
3065;42;25;9;34;-70,7460046;-33,51663183;1
3066;67;36;14;50;-70,74527552;-33,51642231;1
3067;131;100;5;105;-70,78399342;-33,51591962;1
3068;231;138;46;184;-70,74786571;-33,51676171;1
3069;148;95;36;131;-70,76650879;-33,51681547;1
3070;147;104;15;119;-70,78459759;-33,51616254;1
3071;17;14;0;14;-70,7495236;-33,5199566;0
3072;139;101;10;111;-70,78516772;-33,51614743;1
3073;110;74;15;89;-70,76753195;-33,51665783;1
3074;145;104;16;120;-70,78659244;-33,51625075;1
3075;234;153;54;207;-70,76837114;-33,51712002;1
3076;53;40;0;40;-70,79177329;-33,51589299;1
3077;51;33;12;45;-70,76242543;-33,51635758;1
3078;55;35;16;51;-70,75642887;-33,51651946;1
3079;54;36;0;36;-70,75785136;-33,51659096;1
3080;143;107;8;115;-70,78780822;-33,5164503;1
3081;130;92;11;103;-70,78819934;-33,51646529;1
3082;122;90;9;99;-70,78859238;-33,51648804;1
3083;111;94;0;94;-70,78899321;-33,51650826;1
3084;124;100;5;105;-70,7894102;-33,5165362;1
3085;79;49;23;72;-70,77122789;-33,51681346;1
3086;134;98;5;103;-70,78980307;-33,51655833;1
3087;67;37;18;55;-70,77206141;-33,51650473;1
3088;523;338;117;455;-70,75813089;-33,51990946;1
3089;119;92;5;97;-70,7901893;-33,51657998;1
3090;117;85;11;96;-70,79057709;-33,51659367;1
3091;26;19;4;23;-70,74547475;-33,51681859;1
3092;138;100;12;112;-70,7909845;-33,5165904;1
3093;76;51;8;59;-70,76718617;-33,51686427;1
3094;47;35;0;35;-70,79118904;-33,53182713;1
3095;77;55;11;66;-70,77197851;-33,54363765;1
3096;36;18;11;29;-70,774576;-33,51722939;1
3097;90;60;16;76;-70,76822046;-33,53253239;1
3098;182;141;8;149;-70,76905895;-33,54385401;1
3099;88;67;11;78;-70,78111411;-33,51656973;1
3100;63;48;0;48;-70,78340595;-33,53205249;1
3101;66;38;17;55;-70,77783154;-33,54355771;1
3102;73;49;9;58;-70,75642052;-33,5177709;1
3103;117;84;12;96;-70,78194534;-33,53216912;1
3104;59;44;0;44;-70,78417499;-33,54349924;1
3105;118;84;18;102;-70,76434074;-33,51709068;1
3106;90;78;7;85;-70,78219588;-33,51664095;1
3107;101;77;6;83;-70,78279993;-33,51666088;1
3108;363;233;67;300;-70,77605643;-33,51780674;1
3109;131;94;8;102;-70,79392204;-33,51640324;1
3110;192;146;15;161;-70,79540207;-33,5164577;1
3111;224;155;36;191;-70,76010573;-33,51781822;1
3112;34;19;7;26;-70,76241937;-33,51700132;1
3113;239;160;9;169;-70,79654732;-33,51705852;1
3114;87;61;9;70;-70,7852033;-33,51678679;1
3115;575;389;31;420;-70,79733085;-33,51688405;1
3116;77;39;31;70;-70,77228517;-33,51736505;1
3117;464;341;20;361;-70,797959;-33,51709375;1
3118;301;206;57;263;-70,76101173;-33,51881218;1
3119;563;390;32;422;-70,79867462;-33,52002018;1
3120;122;95;5;100;-70,79392624;-33,51674699;1
3121;95;68;14;82;-70,78002237;-33,51706753;1
3122;159;118;4;122;-70,79476425;-33,5170574;1
3123;102;76;6;82;-70,78632073;-33,51688619;1
3124;67;43;17;60;-70,75443487;-33,51737791;1
3125;164;104;36;140;-70,75468563;-33,51793894;1
3126;51;40;6;46;-70,78724743;-33,51689135;1
3127;139;104;5;109;-70,79520272;-33,51711054;1
3128;162;121;9;130;-70,79563002;-33,51715046;1
3129;393;231;103;334;-70,74786286;-33,5180008;1
3130;75;48;14;62;-70,76698906;-33,51749659;1
3131;116;77;20;97;-70,7483843;-33,51798885;1
3132;319;197;61;258;-70,74890864;-33,5179996;1
3133;219;138;37;175;-70,74943222;-33,5180058;1
3134;317;179;72;251;-70,74994115;-33,51800348;1
3135;152;110;10;120;-70,79605628;-33,51719804;1
3136;97;62;11;73;-70,78119362;-33,51756311;1
3137;92;64;8;72;-70,78173456;-33,51757625;1
3138;76;51;13;64;-70,75190202;-33,51783287;1
3139;82;46;29;75;-70,75312923;-33,51782595;1
3140;201;162;13;175;-70,78330816;-33,51720074;1
3141;87;59;11;70;-70,7822551;-33,51763471;1
3142;226;158;20;178;-70,78438671;-33,51762657;1
3143;210;157;18;175;-70,78489449;-33,51767875;1
3144;33;19;9;28;-70,74741847;-33,51810639;1
3145;15;7;6;13;-70,76307913;-33,51763006;0
3146;103;77;6;83;-70,79856635;-33,51729804;1
3147;66;48;0;48;-70,79362794;-33,51714157;1
3148;203;144;22;166;-70,78542981;-33,51770081;1
3149;507;384;39;423;-70,78766675;-33,51819142;1
3150;79;58;6;64;-70,78726232;-33,51743518;1
3151;64;48;4;52;-70,78765486;-33,51744029;1
3152;86;63;0;63;-70,78804301;-33,51745687;1
3153;59;35;11;46;-70,76369398;-33,51803417;1
3154;84;63;4;67;-70,78843521;-33,51746815;1
3155;85;54;20;74;-70,78002625;-33,51752455;1
3156;82;58;5;63;-70,78883112;-33,51748492;1
3157;58;34;10;44;-70,77145784;-33,51768199;1
3158;146;110;6;116;-70,78968458;-33,5180207;1
3159;168;127;9;136;-70,79006751;-33,51806292;1
3160;53;35;16;51;-70,76451973;-33,51792292;1
3161;28;22;0;22;-70,79072222;-33,51743913;1
3162;66;37;21;58;-70,77320857;-33,51774882;1
3163;1114;793;62;855;-70,7923869;-33,51829041;1
3164;58;43;0;43;-70,77719332;-33,51783094;1
3165;19;11;4;15;-70,7767537;-33,51782747;0
3166;28;16;8;24;-70,76109164;-33,5181529;1
3167;110;72;24;96;-70,76504362;-33,51858112;1
3168;65;46;8;54;-70,76638286;-33,51810269;1
3169;126;97;7;104;-70,793935;-33,51761761;1
3170;88;55;21;76;-70,7672634;-33,51838023;1
3171;53;32;12;44;-70,76289166;-33,51812414;1
3172;50;29;12;41;-70,76832482;-33,51813044;1
3173;100;62;21;83;-70,76916967;-33,51847717;1
3174;72;58;0;58;-70,79071108;-33,51780929;1
3175;134;93;17;110;-70,78007435;-33,51798289;1
3176;70;39;22;61;-70,7701808;-33,51818105;1
3177;78;43;18;61;-70,77174183;-33,51821721;1
3178;148;111;0;111;-70,79563893;-33,51787074;1
3179;210;146;22;168;-70,78340308;-33,51804692;1
3180;306;214;43;257;-70,75337563;-33,52073294;1
3181;126;101;0;101;-70,79392844;-33,51795256;1
3182;62;35;19;54;-70,77286993;-33,51862574;1
3183;38;17;11;28;-70,76435002;-33,51838081;1
3184;68;37;22;59;-70,77342601;-33,51863815;1
3185;75;43;19;62;-70,77454235;-33,51831833;1
3186;312;240;8;248;-70,7965604;-33,51883513;1
3187;231;147;21;168;-70,7973231;-33,51830219;1
3188;78;54;17;71;-70,76616713;-33,51865119;1
3189;81;63;4;67;-70,79072453;-33,51813963;1
3190;103;84;0;84;-70,79854218;-33,51829501;1
3191;100;67;15;82;-70,77587487;-33,51959091;1
3192;95;58;20;78;-70,77659216;-33,51872441;1
3193;46;24;17;41;-70,76301656;-33,51867021;1
3194;64;41;19;60;-70,77708986;-33,51873662;1
3195;68;38;24;62;-70,77762949;-33,51876514;1
3196;149;112;10;122;-70,79563326;-33,51821194;1
3197;115;93;4;97;-70,79392407;-33,51828257;1
3198;77;49;17;66;-70,76843931;-33,5189865;1
3199;142;86;12;98;-70,78004876;-33,51847376;1
3200;57;32;17;49;-70,77118879;-33,51903787;1
3201;50;36;9;45;-70,76388109;-33,51879913;1
3202;70;47;16;63;-70,77170907;-33,51905578;1
3203;125;87;11;98;-70,78174894;-33,51850658;1
3204;40;19;17;36;-70,77224955;-33,51884351;1
3205;37;26;0;26;-70,76985369;-33,51877058;1
3206;124;98;5;103;-70,78321243;-33,51855701;1
3207;89;57;6;63;-70,7907389;-33,51846839;1
3208;57;35;14;49;-70,77054729;-33,51908988;1
3209;225;164;6;170;-70,79538544;-33,51850535;1
3210;42;28;9;37;-70,77398526;-33,51889143;1
3211;89;66;4;70;-70,78405758;-33,51879064;1
3212;42;26;8;34;-70,77448995;-33,51891006;1
3213;102;74;4;78;-70,78484995;-33,51859987;1
3214;67;44;11;55;-70,77503935;-33,5189285;1
3215;98;65;19;84;-70,76588518;-33,51917623;1
3216;98;84;0;84;-70,78567028;-33,51888877;1
3217;37;20;7;27;-70,77570147;-33,5189755;1
3218;39;30;0;30;-70,78658343;-33,51872532;1
3219;76;39;27;66;-70,7563937;-33,51923743;1
3220;114;99;0;99;-70,79391592;-33,51861303;1
3221;81;63;0;63;-70,77941804;-33,51903101;1
3222;65;52;6;58;-70,77979905;-33,51903049;1
3223;57;45;0;45;-70,78043964;-33,51878224;1
3224;57;34;13;47;-70,76269572;-33,51916124;1
3225;71;54;5;59;-70,78141266;-33,5187989;1
3226;126;99;12;111;-70,78740155;-33,51940135;1
3227;83;71;0;71;-70,78206246;-33,51908221;1
3228;71;47;6;53;-70,78240008;-33,51909568;1
3229;73;54;0;54;-70,79075239;-33,5188259;1
3230;206;149;7;156;-70,79538063;-33,51883453;1
3231;125;103;11;114;-70,7878264;-33,51944197;1
3232;15;7;8;15;-70,76359047;-33,5194364;0
3233;78;51;11;62;-70,76750472;-33,51924253;1
3234;30;23;0;23;-70,76063055;-33,51942577;1
3235;134;97;14;111;-70,78322736;-33,51890894;1
3236;125;97;8;105;-70,78825445;-33,51948406;1
3237;76;55;6;61;-70,78487502;-33,51894771;1
3238;11;0;0;0;-70,74242932;-33,52305187;0
3239;108;80;0;80;-70,79391128;-33,51894601;1
3240;180;130;17;147;-70,78859136;-33,51952148;1
3241;59;42;0;42;-70,76951864;-33,51933911;1
3242;71;54;0;54;-70,78042979;-33,51932855;1
3243;72;55;4;59;-70,78075782;-33,51932921;1
3244;260;172;52;224;-70,76241709;-33,52058598;1
3245;74;59;6;65;-70,78113063;-33,51933255;1
3246;73;55;0;55;-70,7814566;-33,51934336;1
3247;112;77;9;86;-70,7893217;-33,51958641;1
3248;439;296;28;324;-70,79733491;-33,51939044;1
3249;76;47;6;53;-70,79852253;-33,51926046;1
3250;244;179;11;190;-70,79536337;-33,51916312;1
3251;95;76;0;76;-70,78974565;-33,5196147;1
3252;70;50;7;57;-70,78324244;-33,51923512;1
3253;53;32;0;32;-70,76214846;-33,51976311;1
3254;71;43;17;60;-70,77393232;-33,51950714;1
3255;82;56;8;64;-70,79017535;-33,51966286;1
3256;35;17;14;31;-70,76282303;-33,51963355;1
3257;32;20;0;20;-70,78490819;-33,5192763;0
3258;62;38;10;48;-70,76402622;-33,52001342;1
3259;22;10;8;18;-70,75937692;-33,51983116;0
3260;318;220;49;269;-70,75636405;-33,52085987;1
3261;82;70;0;70;-70,79060021;-33,51969845;1
3262;34;22;0;22;-70,77657781;-33,51955418;1
3263;93;79;0;79;-70,79390533;-33,51929628;1
3264;45;26;10;36;-70,77707129;-33,51956808;1
3265;105;77;8;85;-70,78408471;-33,51964466;1
3266;30;18;0;18;-70,77763574;-33,51958682;0
3267;79;59;7;66;-70,79104967;-33,51973857;1
3268;65;33;21;54;-70,76633696;-33,52011919;1
3269;82;51;17;68;-70,76733508;-33,5198084;1
3270;92;58;16;74;-70,76838072;-33,52012939;1
3271;212;163;9;172;-70,79536255;-33,51951088;1
3272;103;85;6;91;-70,78579572;-33,51974506;1
3273;110;78;7;85;-70,78324415;-33,51956587;1
3274;13;8;0;8;-70,75902362;-33,51989258;0
3275;58;41;7;48;-70,77943986;-33,51972548;1
3276;51;37;6;43;-70,76944607;-33,5198576;1
3277;46;34;0;34;-70,77996008;-33,51958359;1
3278;80;64;0;64;-70,79214483;-33,51984245;1
3279;86;70;0;70;-70,78493041;-33,51960351;1
3280;28;15;0;15;-70,77026656;-33,51989899;0
3281;79;60;11;71;-70,75982467;-33,52040363;1
3282;39;31;4;35;-70,78193027;-33,51962001;1
3283;101;58;25;83;-70,77062475;-33,52048289;1
3284;451;319;24;343;-70,79363749;-33,51998464;1
3285;50;36;0;36;-70,782412;-33,51977617;1
3286;75;39;18;57;-70,77117613;-33,52026939;1
3287;67;36;20;56;-70,77169312;-33,5202813;1
3288;35;18;13;31;-70,77220062;-33,52029458;1
3289;61;34;14;48;-70,77283166;-33,52013759;1
3290;98;67;16;83;-70,77339242;-33,52058229;1
3291;100;57;25;82;-70,77391009;-33,52059828;1
3292;38;28;0;28;-70,78652077;-33,51986725;1
3293;37;31;0;31;-70,78703325;-33,51987625;1
3294;125;81;27;108;-70,77442243;-33,52061542;1
3295;103;79;0;79;-70,78029744;-33,51987828;1
3296;132;91;26;117;-70,77499088;-33,52065196;1
3297;71;44;11;55;-70,76480837;-33,52052474;1
3298;106;83;6;89;-70,78160731;-33,51989711;1
3299;111;89;5;94;-70,78326007;-33,51990258;1
3300;62;41;12;53;-70,75936013;-33,5204929;1
3301;40;22;14;36;-70,76553947;-33,5203204;1
3302;127;76;24;100;-70,77565007;-33,52066068;1
3303;103;66;19;85;-70,77614513;-33,52047425;1
3304;70;36;19;55;-70,77691616;-33,52007099;1
3305;115;87;12;99;-70,78496747;-33,51994353;1
3306;146;116;11;127;-70,76075707;-33,52065267;1
3307;122;78;27;105;-70,77774183;-33,52073744;1
3308;66;33;19;52;-70,76709371;-33,52062232;1
3309;90;65;11;76;-70,79476747;-33,52009156;1
3310;27;17;0;17;-70,76773505;-33,52036756;0
3311;68;55;6;61;-70,7690757;-33,52067397;1
3312;38;28;6;34;-70,76973642;-33,52044668;1
3313;47;33;4;37;-70,79534152;-33,52013941;1
3314;53;34;10;44;-70,77025272;-33,52072812;1
3315;71;52;0;52;-70,77979247;-33,52019014;1
3316;40;32;0;32;-70,79574991;-33,52017551;1
3317;51;44;4;48;-70,78051365;-33,52047515;1
3318;90;68;0;68;-70,78086656;-33,52090897;1
3319;64;56;0;56;-70,78117258;-33,52049025;1
3320;54;41;0;41;-70,78170209;-33,52022715;1
3321;41;30;0;30;-70,79615689;-33,52021291;1
3322;28;28;0;28;-70,78236565;-33,5202446;1
3323;123;95;8;103;-70,78326513;-33,52028848;1
3324;83;64;4;68;-70,78407197;-33,5205894;1
3325;25;18;0;18;-70,79658742;-33,52025174;0
3326;156;108;9;117;-70,78499935;-33,52033895;1
3327;78;43;26;69;-70,77727425;-33,520916;1
3328;71;48;8;56;-70,78592194;-33,52057609;1
3329;121;87;11;98;-70,78664287;-33,52085227;1
3330;131;98;5;103;-70,78713414;-33,52088554;1
3331;45;25;0;25;-70,76381478;-33,52080608;1
3332;120;101;4;105;-70,78757735;-33,52110035;1
3333;70;59;0;59;-70,77981049;-33,52047194;1
3334;130;105;8;113;-70,78800249;-33,52112558;1
3335;120;96;0;96;-70,78842444;-33,52113589;1
3336;179;134;12;146;-70,78893471;-33,52116205;1
3337;37;30;0;30;-70,78171575;-33,52051074;1
3338;66;31;28;59;-70,76593139;-33,52089588;1
3339;123;96;6;102;-70,78947763;-33,52116888;1
3340;30;0;0;0;-70,78236566;-33,52052653;0
3341;134;105;7;112;-70,7899101;-33,52118761;1
3342;55;37;11;48;-70,76804175;-33,52094698;1
3343;41;25;0;25;-70,77278949;-33,52097811;1
3344;163;122;9;131;-70,79032379;-33,52119695;1
3345;128;92;8;100;-70,78325014;-33,52063215;1
3346;118;94;8;102;-70,79074755;-33,52121666;1
3347;122;96;9;105;-70,79120188;-33,52123376;1
3348;67;55;0;55;-70,79179588;-33,52087913;1
3349;108;90;6;96;-70,78501771;-33,52068834;1
3350;39;29;4;33;-70,79225294;-33,52088163;1
3351;65;46;0;46;-70,77981932;-33,52074275;1
3352;545;383;17;400;-70,79283111;-33,52129757;1
3353;70;50;5;55;-70,75764562;-33,52133921;1
3354;1001;673;185;858;-70,758651;-33,52275338;1
3355;204;146;11;157;-70,79373822;-33,52087837;1
3356;31;17;9;26;-70,76972444;-33,52103284;1
3357;30;0;0;0;-70,75882696;-33,52122609;0
3358;33;30;0;30;-70,78170719;-33,52078148;1
3359;27;0;0;0;-70,78234964;-33,52079709;0
3360;473;336;25;361;-70,7947241;-33,52137463;1
3361;58;38;15;53;-70,76068961;-33,52124071;1
3362;67;43;18;61;-70,77165936;-33,5211058;1
3363;114;94;0;94;-70,79532851;-33,52137299;1
3364;121;103;7;110;-70,79573592;-33,52139313;1
3365;111;84;7;91;-70,79614871;-33,52140445;1
3366;158;113;6;119;-70,79658347;-33,52141768;1
3367;71;52;0;52;-70,78322422;-33,52096632;1
3368;83;62;4;66;-70,7971937;-33,52112655;1
3369;89;64;5;69;-70,79762253;-33,52114424;1
3370;157;110;28;138;-70,76199702;-33,52357874;1
3371;79;66;0;66;-70,79803302;-33,52115961;1
3372;62;50;0;50;-70,77953146;-33,52128817;1
3373;86;56;25;81;-70,76332188;-33,52190005;1
3374;69;57;5;62;-70,7799105;-33,52130406;1
3375;64;42;9;51;-70,79844514;-33,5211982;1
3376;81;51;19;70;-70,76374072;-33,52190977;1
3377;75;56;4;60;-70,78023608;-33,52130916;1
3378;105;86;0;86;-70,78503545;-33,52102621;1
3379;68;57;0;57;-70,78056314;-33,5213234;1
3380;123;86;21;107;-70,76415956;-33,52192166;1
3381;73;50;8;58;-70,78121984;-33,52134159;1
3382;109;54;39;93;-70,76458269;-33,52194586;1
3383;48;37;0;37;-70,78170777;-33,52105103;1
3384;97;63;25;88;-70,76510285;-33,52195462;1
3385;33;26;0;26;-70,78233146;-33,52106549;1
3386;113;59;29;88;-70,76564346;-33,5219777;1
3387;110;62;26;88;-70,7666539;-33,52144392;1
3388;73;36;22;58;-70,77648841;-33,52132435;1
3389;109;84;8;92;-70,78607174;-33,52147705;1
3390;613;433;34;467;-70,76793053;-33,52204304;1
3391;90;68;5;73;-70,78402762;-33,52145508;1
3392;516;366;37;403;-70,7690465;-33,52326105;1
3393;112;92;4;96;-70,78321786;-33,52130159;1
3394;65;44;14;58;-70,76068176;-33,52165771;1
3395;69;46;12;58;-70,76956205;-33,52198342;1
3396;42;29;0;29;-70,78170625;-33,52132241;1
3397;74;49;11;60;-70,77001799;-33,52200011;1
3398;103;80;6;86;-70,77049081;-33,52223116;1
3399;145;112;10;122;-70,78504146;-33,52136611;1
3400;24;18;0;18;-70,78231704;-33,52133589;0
3401;53;35;11;46;-70,77156881;-33,52166342;1
3402;309;197;82;279;-70,77277736;-33,52296725;1
3403;49;20;26;46;-70,77392869;-33,52173502;1
3404;32;23;0;23;-70,75635269;-33,52200086;1
3405;98;73;12;85;-70,76185719;-33,52246205;1
3406;97;69;17;86;-70,7666398;-33,52183262;1
3407;32;25;0;25;-70,75987826;-33,52194113;1
3408;200;136;36;172;-70,77518421;-33,52302557;1
3409;52;38;6;44;-70,78170573;-33,52162388;1
3410;106;85;0;85;-70,78319564;-33,52165034;1
3411;114;83;7;90;-70,79352028;-33,52201566;1
3412;31;23;0;23;-70,78229603;-33,5216402;1
3413;59;36;10;46;-70,77661676;-33,52183449;1
3414;52;43;0;43;-70,79205828;-33,5215514;1
3415;197;150;0;150;-70,78505943;-33,52172681;1
3416;29;21;0;21;-70,77761539;-33,52185263;1
3417;41;32;0;32;-70,78699391;-33,52175926;1
3418;18;13;0;13;-70,77871353;-33,5230884;0
3419;102;72;14;86;-70,77962319;-33,52236237;1
3420;69;50;12;62;-70,77155682;-33,5221021;1
3421;44;35;0;35;-70,78028944;-33,52200462;1
3422;149;96;25;121;-70,75636686;-33,52313613;1
3423;88;56;17;73;-70,76663293;-33,52220206;1
3424;64;48;5;53;-70,78117346;-33,5220375;1
3425;58;45;0;45;-70,75984584;-33,52259454;1
3426;83;63;7;70;-70,78185005;-33,52241884;1
3427;79;62;10;72;-70,76219814;-33,5227265;1
3428;51;42;4;46;-70,79208494;-33,52193908;1
3429;42;27;0;27;-70,77368498;-33,52220997;1
3430;72;48;12;60;-70,77437207;-33,52250314;1
3431;83;63;8;71;-70,78233026;-33,52243606;1
3432;57;39;8;47;-70,78298931;-33,52209737;1
3433;110;79;6;85;-70,79780274;-33,52187744;1
3434;60;44;0;44;-70,78362095;-33,52228713;1
3435;49;41;0;41;-70,78405865;-33,52229969;1
3436;37;25;0;25;-70,77762328;-33,52223695;1
3437;68;44;11;55;-70,77626001;-33,52239789;1
3438;43;35;0;35;-70,78474536;-33,52216671;1
3439;47;35;5;40;-70,78559147;-33,52219627;1
3440;56;38;7;45;-70,7610426;-33,52269261;1
3441;89;58;15;73;-70,78630471;-33,52258423;1
3442;126;95;7;102;-70,78755897;-33,52224998;1
3443;53;32;13;45;-70,77105458;-33,52268611;1
3444;46;24;18;42;-70,77153717;-33,52270597;1
3445;82;47;27;74;-70,76662246;-33,52257769;1
3446;45;20;14;34;-70,77201572;-33,52271294;1
3447;52;36;5;41;-70,78012219;-33,52257424;1
3448;86;58;7;65;-70,78866994;-33,522644;1
3449;110;85;8;93;-70,78099128;-33,52241115;1
3450;82;61;6;67;-70,789085;-33,52265772;1
3451;96;69;7;76;-70,79000373;-33,52232648;1
3452;54;45;0;45;-70,75444411;-33,52383882;1
3453;47;29;6;35;-70,79718265;-33,52238443;1
3454;71;51;0;51;-70,79802001;-33,52223554;1
3455;81;65;0;65;-70,79091289;-33,52270496;1
3456;91;65;8;73;-70,79136343;-33,52272395;1
3457;46;33;0;33;-70,78275313;-33,52265298;1
3458;34;18;12;30;-70,77368152;-33,52275554;1
3459;23;21;0;21;-70,77763609;-33,52339759;1
3460;97;72;0;72;-70,79199042;-33,52273948;1
3461;76;59;0;59;-70,79244358;-33,52275264;1
3462;80;61;10;71;-70,79286558;-33,52276567;1
3463;53;45;0;45;-70,78451146;-33,52271034;1
3464;19;15;0;15;-70,79328771;-33,52277543;0
3465;51;40;0;40;-70,78493648;-33,52273491;1
3466;63;51;0;51;-70,7937078;-33,52276637;1
3467;23;19;0;19;-70,7853641;-33,52255771;0
3468;16;12;0;12;-70,79409471;-33,52278471;0
3469;611;466;29;495;-70,79616462;-33,5228244;1
3470;635;385;147;532;-70,76377558;-33,52462013;1
3471;35;22;7;29;-70,77676168;-33,5227706;1
3472;40;26;8;34;-70,76975262;-33,52304339;1
3473;30;18;7;25;-70,77570256;-33,52280652;1
3474;10;0;0;0;-70,76412178;-33,5229411;0
3475;108;75;6;81;-70,78758704;-33,52263179;1
3476;65;32;24;56;-70,76475714;-33,52295952;1
3477;29;18;9;27;-70,76552486;-33,52297985;1
3478;33;23;6;29;-70,78072099;-33,52277097;1
3479;27;20;0;20;-70,76618134;-33,52339291;0
3480;122;69;26;95;-70,76663368;-33,523383;1
3481;99;62;19;81;-70,76705923;-33,52337471;1
3482;755;539;53;592;-70,76820103;-33,52391744;1
3483;90;72;0;72;-70,7980103;-33,52258879;1
3484;104;81;0;81;-70,79002017;-33,52270261;1
3485;88;70;9;79;-70,78359838;-33,52284358;1
3486;60;44;0;44;-70,78561708;-33,5229346;1
3487;112;85;4;89;-70,78761917;-33,52298821;1
3488;32;20;9;29;-70,77426719;-33,52334711;1
3489;106;84;0;84;-70,77967526;-33,52371638;1
3490;81;51;20;71;-70,77098938;-33,52405956;1
3491;79;51;17;68;-70,77627492;-33,5233315;1
3492;100;65;20;85;-70,7704123;-33,52388267;1
3493;66;47;6;53;-70,78043183;-33,52318145;1
3494;56;37;11;48;-70,77180754;-33,52331798;1
3495;102;72;11;83;-70,79003059;-33,52305683;1
3496;80;62;9;71;-70,77053044;-33,5326473;1
3497;61;43;6;49;-70,77390016;-33,54377346;1
3498;115;83;10;93;-70,76618549;-33,53251336;1
3499;70;48;6;54;-70,77562144;-33,5437067;1
3500;112;76;15;91;-70,77199887;-33,53273764;1
3501;69;54;8;62;-70,76712835;-33,54385665;1
3502;34;0;0;0;-70,79625441;-33,53202718;0
3503;72;51;9;60;-70,76455328;-33,54385838;1
3504;43;31;6;37;-70,76749785;-33,53240247;1
3505;40;32;0;32;-70,77084228;-33,5437876;1
3506;59;31;0;31;-70,79734152;-33,53206483;1
3507;140;113;8;121;-70,78014882;-33,5323059;1
3508;101;69;12;81;-70,76858908;-33,53277001;1
3509;110;84;9;93;-70,76552531;-33,54415557;1
3510;66;47;0;47;-70,79874405;-33,53218599;1
3511;30;19;7;26;-70,77234103;-33,54382894;1
3512;80;63;5;68;-70,78457969;-33,5323427;1
3513;77;54;8;62;-70,77348204;-33,54396123;1
3514;125;96;12;108;-70,7782268;-33,53243135;1
3515;85;66;9;75;-70,76968011;-33,54396485;1
3516;67;43;5;48;-70,78352388;-33,54375672;1
3517;88;64;11;75;-70,77582494;-33,54402704;1
3518;38;30;0;30;-70,76734604;-33,54419044;1
3519;68;43;13;56;-70,76475706;-33,5441785;1
3520;52;42;0;42;-70,77127485;-33,54413601;1
3521;75;44;11;55;-70,77286635;-33,54423866;1
3522;105;75;14;89;-70,7634491;-33,54435379;1
3523;118;83;4;87;-70,78518392;-33,54417472;1
3524;71;47;0;47;-70,78384924;-33,54398285;1
3525;24;15;0;15;-70,77685157;-33,54400457;0
3526;77;52;14;66;-70,77508731;-33,54439634;1
3527;76;55;9;64;-70,76987777;-33,54426675;1
3528;148;100;28;128;-70,76574182;-33,54451759;1
3529;24;20;0;20;-70,77173184;-33,54410628;0
3530;280;188;15;203;-70,78661722;-33,54465712;1
3531;40;29;0;29;-70,77089495;-33,54430732;1
3532;100;78;7;85;-70,77604833;-33,5443668;1
3533;52;35;5;40;-70,77243995;-33,54443104;1
3534;56;37;6;43;-70,76873006;-33,5444023;1
3535;92;64;7;71;-70,77414282;-33,5443801;1
3536;57;42;0;42;-70,78420868;-33,54423256;1
3537;75;54;4;58;-70,78318797;-33,54428177;1
3538;77;60;12;72;-70,76757669;-33,54455232;1
3539;129;78;18;96;-70,76365921;-33,54468305;1
3540;52;39;0;39;-70,77048772;-33,54451948;1
3541;66;52;6;58;-70,77206448;-33,54460457;1
3542;119;75;22;97;-70,76594369;-33,54484963;1
3543;31;20;0;20;-70,79096872;-33,54577861;0
3544;68;51;0;51;-70,76892914;-33,54470621;1
3545;40;29;5;34;-70,77011084;-33,54469172;1
3546;77;50;8;58;-70,77169752;-33,54477036;1
3547;55;36;11;47;-70,77434708;-33,54469668;1
3548;68;48;0;48;-70,78469413;-33,54457182;1
3549;245;173;11;184;-70,76218365;-33,54538905;1
3550;114;76;11;87;-70,76389021;-33,54498514;1
3551;79;58;9;67;-70,76779053;-33,54486609;1
3552;70;46;6;52;-70,77131804;-33,5449442;1
3553;52;38;4;42;-70,76974185;-33,54485932;1
3554;14;11;0;11;-70,7730746;-33,54530835;0
3555;199;137;0;137;-70,78460981;-33,5452678;1
3556;168;133;17;150;-70,76683587;-33,54529862;1
3557;82;54;14;68;-70,77456672;-33,54503682;1
3558;60;45;0;45;-70,77088853;-33,54513757;1
3559;118;84;16;100;-70,76411567;-33,54528985;1
3560;68;40;0;40;-70,78518489;-33,54490349;1
3561;81;64;5;69;-70,76798376;-33,54517988;1
3562;121;86;4;90;-70,78661001;-33,54515853;1
3563;985;686;37;723;-70,77315006;-33,54740489;1
3564;65;44;9;53;-70,7705127;-33,54531009;1
3565;466;332;0;332;-70,76071141;-33,54608844;1
3566;101;80;9;89;-70,76577772;-33,54541276;1
3567;48;38;0;38;-70,78554539;-33,54515705;1
3568;62;40;13;53;-70,77014426;-33,54547911;1
3569;104;84;9;93;-70,76431265;-33,54561661;1
3570;152;113;10;123;-70,7551343;-33,55045596;1
3571;169;113;8;121;-70,76255427;-33,54586627;1
3572;99;67;9;76;-70,77228754;-33,54567474;1
3573;113;79;0;79;-70,78789737;-33,54557701;1
3574;66;53;0;53;-70,76823446;-33,54550375;1
3575;57;41;7;48;-70,76975385;-33,54565011;1
3576;81;62;0;62;-70,76923395;-33,54576832;1
3577;64;43;0;43;-70,78586889;-33,54539148;1
3578;115;81;18;99;-70,77190297;-33,54584478;1
3579;125;104;10;114;-70,76597099;-33,54572609;1
3580;263;184;14;198;-70,77702254;-33,54956507;1
3581;145;111;9;120;-70,76467927;-33,5459196;1
3582;110;79;8;87;-70,76837392;-33,54581997;1
3583;66;41;15;56;-70,77102792;-33,54579742;1
3584;45;35;0;35;-70,7862045;-33,54560674;1
3585;100;74;0;74;-70,76278862;-33,54606373;1
3586;124;80;0;80;-70,77560551;-33,54600894;1
3587;89;57;0;57;-70,76142492;-33,54604477;1
3588;47;34;0;34;-70,76745457;-33,54585705;1
3589;126;87;17;104;-70,76616874;-33,54603414;1
3590;110;88;5;93;-70,76855924;-33,54610115;1
3591;153;118;7;125;-70,76488014;-33,54624117;1
3592;135;97;16;113;-70,76732664;-33,54647163;1
3593;105;72;6;78;-70,75910221;-33,54634307;1
3594;93;65;5;70;-70,77123767;-33,54611419;1
3595;84;63;0;63;-70,76294968;-33,54629958;1
3596;73;48;10;58;-70,77026312;-33,54614655;1
3597;209;143;4;147;-70,76106522;-33,54652441;1
3598;48;34;5;39;-70,7676402;-33,54614367;1
3599;64;40;0;40;-70,77581795;-33,54634364;1
3600;116;80;4;84;-70,76483338;-33,54767813;1
3601;76;62;7;69;-70,76637919;-33,54638492;1
3602;44;30;0;30;-70,78691269;-33,54604134;1
3603;900;607;15;622;-70,79088034;-33,54867085;1
3604;97;73;8;81;-70,76874787;-33,54639171;1
3605;140;106;8;114;-70,765078;-33,54655249;1
3606;108;75;6;81;-70,75928387;-33,54661465;1
3607;68;48;7;55;-70,77146532;-33,54646033;1
3608;159;102;0;102;-70,76345691;-33,54675091;1
3609;65;52;8;60;-70,77047002;-33,54646616;1
3610;48;42;0;42;-70,76782627;-33,54643021;1
3611;59;45;4;49;-70,76976843;-33,54657477;1
3612;63;45;0;45;-70,77651238;-33,54651127;1
3613;69;52;10;62;-70,76660344;-33,54671325;1
3614;77;56;0;56;-70,75961218;-33,54708983;1
3615;114;90;7;97;-70,76898125;-33,54674268;1
3616;90;67;10;77;-70,76528759;-33,54687943;1
3617;82;53;0;53;-70,75933696;-33,54689909;1
3618;29;20;5;25;-70,76801455;-33,54672697;1
3619;82;53;0;53;-70,77392965;-33,54683963;1
3620;56;43;0;43;-70,77069762;-33,54681354;1
3621;399;277;24;301;-70,77263315;-33,54768159;1
3622;125;79;22;101;-70,76689147;-33,54712185;1
3623;176;118;0;118;-70,76165148;-33,54727322;1
3624;65;43;0;43;-70,77564;-33,54689911;1
3625;84;75;4;79;-70,76918115;-33,54706095;1
3626;33;21;0;21;-70,7634043;-33,54712487;1
3627;75;56;4;60;-70,76547591;-33,54717131;1
3628;96;61;0;61;-70,77413884;-33,5471458;1
3629;113;77;0;77;-70,75978068;-33,5473262;1
3630;76;57;4;61;-70,76815884;-33,54715096;1
3631;177;126;0;126;-70,76183245;-33,54753265;1
3632;80;62;0;62;-70,76356655;-33,5473735;1
3633;82;61;6;67;-70,76567147;-33,54745593;1
3634;339;234;17;251;-70,77183027;-33,5480832;1
3635;101;78;8;86;-70,76940076;-33,54740853;1
3636;156;101;7;108;-70,75996572;-33,54768121;1
3637;72;60;8;68;-70,7672883;-33,54756068;1
3638;120;86;0;86;-70,7743455;-33,54746536;1
3639;173;124;0;124;-70,76199291;-33,54777644;1
3640;56;38;6;44;-70,76838077;-33,54748023;1
3641;153;101;5;106;-70,7637936;-33,54772553;1
3642;274;189;9;198;-70,79180453;-33,54777874;1
3643;91;60;10;70;-70,76586391;-33,54774889;1
3644;351;237;19;256;-70,77051293;-33,54869015;1
3645;111;75;4;79;-70,76221177;-33,54829851;1
3646;104;72;0;72;-70,76019132;-33,54794869;1
3647;87;70;0;70;-70,76751481;-33,54788939;1
3648;55;45;4;49;-70,76859371;-33,54780363;1
3649;444;300;14;314;-70,77149611;-33,5495044;1
3650;98;79;0;79;-70,76612226;-33,54811847;1
3651;112;75;6;81;-70,79474414;-33,54772099;1
3652;414;281;7;288;-70,76312341;-33,54853586;1
3653;107;68;0;68;-70,76076008;-33,54817244;1
3654;84;63;11;74;-70,76772869;-33,54821022;1
3655;285;206;9;215;-70,77357279;-33,54923528;1
3656;75;51;13;64;-70,78257388;-33,55032568;1
3657;170;114;0;114;-70,76243744;-33,54848216;1
3658;155;108;0;108;-70,79566843;-33,54796031;1
3659;347;226;6;232;-70,76059621;-33,5499455;1
3660;390;259;8;267;-70,76923695;-33,54931508;1
3661;35;26;0;26;-70,76456964;-33,54831317;1
3662;98;75;5;80;-70,76635142;-33,54844857;1
3663;149;109;4;113;-70,79529507;-33,54817596;1
3664;481;323;7;330;-70,77014642;-33,54943482;1
3665;46;33;0;33;-70,76420883;-33,54848044;1
3666;96;78;6;84;-70,76556032;-33,54880266;1
3667;89;64;0;64;-70,76068246;-33,54868053;1
3668;87;70;5;75;-70,76656598;-33,54876485;1
3669;77;48;0;48;-70,76370024;-33,548718;1
3670;148;100;4;104;-70,79496034;-33,54840091;1
3671;79;59;0;59;-70,76493278;-33,54886366;1
3672;169;109;0;109;-70,7609039;-33,549237;1
3673;267;188;4;192;-70,76765804;-33,54916699;1
3674;77;60;0;60;-70,79464322;-33,54864933;1
3675;34;21;4;25;-70,76448895;-33,54889342;1
3676;48;39;0;39;-70,76319098;-33,54895113;1
3677;76;51;0;51;-70,79634786;-33,54851457;1
3678;531;361;12;373;-70,76953125;-33,55088152;1
3679;440;324;23;347;-70,79373107;-33,55196205;1
3680;78;51;7;58;-70,79665611;-33,54878025;1
3681;170;113;5;118;-70,76707388;-33,54952167;1
3682;133;97;0;97;-70,79556967;-33,54904587;1
3683;141;98;0;98;-70,76417512;-33,54948854;1
3684;40;24;0;24;-70,76343814;-33,5493761;1
3685;359;245;18;263;-70,76403332;-33,54996068;1
3686;172;118;4;122;-70,79584418;-33,54933273;1
3687;31;25;0;25;-70,76263218;-33,54991155;1
3688;119;82;4;86;-70,76588132;-33,54994495;1
3689;163;122;6;128;-70,76710487;-33,55019295;1
3690;489;345;11;356;-70,7963872;-33,5498997;1
3691;177;131;6;137;-70,79452352;-33,54976995;1
3692;350;245;17;262;-70,76861354;-33,55679157;1
3693;194;140;7;147;-70,79764085;-33,55015221;1
3694;188;120;8;128;-70,79479501;-33,5500606;1
3695;73;52;0;52;-70,7658045;-33,55057969;1
3696;151;107;12;119;-70,7842688;-33,55261646;1
3697;65;48;0;48;-70,76542043;-33,55076125;1
3698;519;359;9;368;-70,79533951;-33,55062591;1
3699;51;35;0;35;-70,76711848;-33,55055495;1
3700;58;36;0;36;-70,76730054;-33,55083397;1
3701;53;36;0;36;-70,76419438;-33,55098455;1
3702;171;120;0;120;-70,76815573;-33,55096542;1
3703;85;57;4;61;-70,76677129;-33,55132157;1
3704;114;70;0;70;-70,76220492;-33,55139958;1
3705;64;38;0;38;-70,76441812;-33,55129938;1
3706;71;45;0;45;-70,76601166;-33,55127682;1
3707;212;143;5;148;-70,76376375;-33,55158606;1
3708;173;124;12;136;-70,76814561;-33,55176133;1
3709;230;162;0;162;-70,79634741;-33,55163046;1
3710;107;72;0;72;-70,76319368;-33,55186457;1
3711;38;26;0;26;-70,7662252;-33,55159569;1
3712;57;36;4;40;-70,76230888;-33,55183925;1
3713;0;0;0;0;-70,76019849;-33,552547;0
3714;111;75;0;75;-70,79549108;-33,55184663;1
3715;68;46;0;46;-70,76641963;-33,55187813;1
3716;44;26;4;30;-70,76500334;-33,5518924;1
3717;165;114;4;118;-70,76863917;-33,55219979;1
3718;48;37;0;37;-70,7666522;-33,55219421;1
3719;51;37;0;37;-70,7697788;-33,55233375;1
3720;176;120;5;125;-70,76918186;-33,5528808;1
3721;168;109;0;109;-70,79711084;-33,55223535;1
3722;178;125;0;125;-70,79690516;-33,55249255;1
3723;103;77;16;93;-70,77356147;-33,5556711;1
3724;406;273;7;280;-70,76669616;-33,55370102;1
3725;54;36;0;36;-70,76949882;-33,55278569;1
3726;177;118;5;123;-70,79669924;-33,55274998;1
3727;208;132;4;136;-70,79645298;-33,55300323;1
3728;61;37;0;37;-70,76714576;-33,55328768;1
3729;163;110;4;114;-70,76917365;-33,55376691;1
3730;62;38;0;38;-70,76782053;-33,55393701;1
3731;83;56;0;56;-70,76633767;-33,55396134;1
3732;263;178;5;183;-70,76554785;-33,55430924;1
3733;129;109;4;113;-70,79272061;-33,55388584;1
3734;59;39;0;39;-70,7659709;-33,55412359;1
3735;64;44;0;44;-70,76513871;-33,55449001;1
3736;26;15;0;15;-70,76475664;-33,55465154;0
3737;67;55;0;55;-70,79085307;-33,55447132;1
3738;72;60;0;60;-70,7905017;-33,55468033;1
3739;242;186;19;205;-70,79240738;-33,55561988;1
3740;0;0;0;0;-70,7962559;-33,55511432;0
3741;58;42;9;51;-70,79014466;-33,55488433;1
3742;28;0;0;0;-70,78965303;-33,5551504;0
3743;38;31;0;31;-70,79265778;-33,55502473;1
3744;233;180;14;194;-70,79154851;-33,55626474;1
3745;153;115;16;131;-70,79515001;-33,55505368;1
3746;82;60;0;60;-70,79059671;-33,55536858;1
3747;85;65;5;70;-70,78918303;-33,5554445;1
3748;23;0;10;10;-70,7947957;-33,55549355;0
3749;82;67;4;71;-70,79084604;-33,55565261;1
3750;68;46;9;55;-70,79510996;-33,55568139;1
3751;56;38;0;38;-70,7884215;-33,5559416;1
3752;182;130;23;153;-70,79358581;-33,55672019;1
3753;51;37;8;45;-70,7897649;-33,55585025;1
3754;61;45;0;45;-70,7965934;-33,55585519;1
3755;87;61;4;65;-70,79117347;-33,55591142;1
3756;56;44;0;44;-70,79543772;-33,55588617;1
3757;74;60;0;60;-70,78805688;-33,55615689;1
3758;65;49;8;57;-70,7940304;-33,55612504;1
3759;67;53;7;60;-70,79630185;-33,55611279;1
3760;62;48;0;48;-70,78770738;-33,55636341;1
3761;209;157;18;175;-70,78993648;-33,55699248;1
3762;86;69;7;76;-70,79433904;-33,55635387;1
3763;79;61;7;68;-70,79600789;-33,55637197;1
3764;169;120;11;131;-70,77734649;-33,55806182;1
3765;39;31;0;31;-70,79021848;-33,55648698;1
3766;20;14;0;14;-70,78718871;-33,55664414;0
3767;205;148;24;172;-70,79493244;-33,55779699;1
3768;265;202;24;226;-70,78969991;-33,55753545;1
3769;77;62;8;70;-70,79463302;-33,55659014;1
3770;24;17;4;21;-70,7956318;-33,55671212;1
3771;76;51;13;64;-70,78813134;-33,55686728;1
3772;70;54;9;63;-70,78666902;-33,55691214;1
3773;193;132;34;166;-70,79277711;-33,55664364;1
3774;80;57;9;66;-70,79523065;-33,55704437;1
3775;100;80;4;84;-70,7883916;-33,55716129;1
3776;43;32;5;37;-70,78531666;-33,55724929;1
3777;69;61;0;61;-70,7949349;-33,55729905;1
3778;78;62;10;72;-70,79247763;-33,55739507;1
3779;65;53;0;53;-70,7872756;-33,5573577;1
3780;22;0;0;0;-70,78476756;-33,55753318;0
3781;69;60;4;64;-70,78863729;-33,55745062;1
3782;84;61;12;73;-70,79281811;-33,55764689;1
3783;78;66;6;72;-70,78887577;-33,55774354;1
3784;46;32;6;38;-70,78751848;-33,55765754;1
3785;233;171;30;201;-70,78763396;-33,55868961;1
3786;300;215;37;252;-70,78653587;-33,55808693;1
3787;166;120;23;143;-70,79146253;-33,55847347;1
3788;82;58;8;66;-70,79312436;-33,55791291;1
3789;62;42;10;52;-70,7942872;-33,55786953;1
3790;96;67;0;67;-70,78282454;-33,55827828;1
3791;52;37;0;37;-70,78775183;-33,5579322;1
3792;67;54;6;60;-70,79174465;-33,55799695;1
3793;61;41;12;53;-70,79398843;-33,55812785;1
3794;69;46;0;46;-70,78234589;-33,55857974;1
3795;79;63;6;69;-70,78559588;-33,55838265;1
3796;258;196;34;230;-70,7848882;-33,55911138;1
3797;42;32;4;36;-70,78798271;-33,55821688;1
3798;93;61;0;61;-70,78189383;-33,5587323;1
3799;51;41;0;41;-70,79210211;-33,55827727;1
3800;80;58;9;67;-70,79369609;-33,55838436;1
3801;209;153;19;172;-70,79056701;-33,55836792;1
3802;156;104;29;133;-70,79280686;-33,55954756;1
3803;96;70;8;78;-70,78583433;-33,55874887;1
3804;46;32;5;37;-70,78823029;-33,55852066;1
3805;62;51;5;56;-70,79241819;-33,55852528;1
3806;49;34;0;34;-70,78057049;-33,55872233;1
3807;24;0;0;0;-70,79330181;-33,55875803;0
3808;156;106;26;132;-70,77077656;-33,56224276;1
3809;48;30;10;40;-70,78408763;-33,55928196;1
3810;87;69;7;76;-70,78607701;-33,55911101;1
3811;101;79;7;86;-70,79092899;-33,55919083;1
3812;42;27;0;27;-70,7808616;-33,55924438;1
3813;79;52;10;62;-70,79287608;-33,55910649;1
3814;98;62;19;81;-70,78630518;-33,55949261;1
3815;46;33;9;42;-70,79001533;-33,55929679;1
3816;191;136;8;144;-70,77921855;-33,56002855;1
3817;51;39;7;46;-70,79055521;-33,55949256;1
3818;193;134;31;165;-70,78901159;-33,56049804;1
3819;81;53;6;59;-70,79218865;-33,55969212;1
3820;48;31;0;31;-70,7776372;-33,55995529;1
3821;37;26;7;33;-70,79016579;-33,55982966;1
3822;163;117;21;138;-70,78958481;-33,56045914;1
3823;78;58;14;72;-70,79073245;-33,56000611;1
3824;70;54;0;54;-70,79188799;-33,55996265;1
3825;569;400;30;430;-70,78309788;-33,56176286;1
3826;43;28;0;28;-70,7897738;-33,56011972;1
3827;85;64;7;71;-70,79159375;-33,56022235;1
3828;45;32;0;32;-70,77641805;-33,56032847;1
3829;208;153;18;171;-70,79048948;-33,56168243;1
3830;38;30;0;30;-70,77798022;-33,56050463;1
3831;217;171;26;197;-70,78756807;-33,56068474;1
3832;76;60;9;69;-70,79129919;-33,56048453;1
3833;45;40;0;40;-70,7831116;-33,56056318;1
3834;50;32;9;41;-70,79090266;-33,56084252;1
3835;101;71;9;80;-70,78273219;-33,56111509;1
3836;101;82;9;91;-70,78391208;-33,56099094;1
3837;42;24;0;24;-70,77488933;-33,56096453;1
3838;1585;1124;78;1202;-70,77718559;-33,56279649;1
3839;92;64;13;77;-70,78777243;-33,56103738;1
3840;29;21;0;21;-70,77685491;-33,56099903;1
3841;260;184;33;217;-70,78340359;-33,56210643;1
3842;92;63;12;75;-70,79049376;-33,56119536;1
3843;24;17;0;17;-70,78193762;-33,56157349;0
3844;87;67;10;77;-70,78810023;-33,56128191;1
3845;177;128;25;153;-70,78687851;-33,56225536;1
3846;72;54;0;54;-70,78840762;-33,56152853;1
3847;41;27;0;27;-70,77526649;-33,56166327;1
3848;49;42;5;47;-70,78702423;-33,56164212;1
3849;182;125;33;158;-70,78427431;-33,56261574;1
3850;81;61;0;61;-70,77944271;-33,56178426;1
3851;84;58;9;67;-70,78870878;-33,56177574;1
3852;69;45;0;45;-70,78987269;-33,56171936;1
3853;133;91;19;110;-70,78371933;-33,56238041;1
3854;52;34;6;40;-70,7873583;-33,56190639;1
3855;85;65;8;73;-70,78957601;-33,5619775;1
3856;288;211;34;245;-70,7859107;-33,56206949;1
3857;52;39;0;39;-70,78767128;-33,56215379;1
3858;75;52;12;64;-70,78927942;-33,56223723;1
3859;59;39;0;39;-70,78042762;-33,56253328;1
3860;69;54;0;54;-70,77800283;-33,56239797;1
3861;187;137;18;155;-70,78833745;-33,56342653;1
3862;46;34;0;34;-70,78798986;-33,56240259;1
3863;20;15;5;20;-70,78886348;-33,56261579;0
3864;57;35;4;39;-70,77993269;-33,56268733;1
3865;47;30;0;30;-70,77948296;-33,56287296;1
3866;119;88;11;99;-70,785476;-33,56295544;1
3867;64;44;0;44;-70,77900484;-33,5630889;1
3868;68;52;7;59;-70,78843255;-33,56297963;1
3869;808;556;31;587;-70,77483668;-33,56462592;1
3870;111;86;12;98;-70,78579061;-33,56321188;1
3871;68;40;5;45;-70,77874076;-33,56340791;1
3872;105;76;8;84;-70,78612132;-33,5634739;1
3873;130;93;21;114;-70,78128791;-33,56369044;1
3874;80;62;0;62;-70,78113682;-33,56324881;1
3875;62;43;0;43;-70,77690126;-33,56337457;1
3876;286;208;21;229;-70,78412371;-33,56452888;1
3877;105;71;9;80;-70,7864425;-33,5637418;1
3878;48;40;5;45;-70,78775376;-33,56356033;1
3879;128;102;15;117;-70,78165811;-33,56397011;1
3880;195;134;7;141;-70,77741802;-33,56438347;1
3881;68;51;11;62;-70,7844785;-33,56383043;1
3882;80;56;6;62;-70,77978647;-33,56385979;1
3883;71;54;4;58;-70,78744223;-33,56383276;1
3884;79;59;9;68;-70,78479698;-33,56408614;1
3885;71;53;7;60;-70,78012401;-33,56440166;1
3886;71;57;7;64;-70,78713891;-33,56409212;1
3887;42;26;0;26;-70,77527449;-33,56421943;1
3888;38;26;0;26;-70,77916106;-33,56424096;1
3889;92;63;8;71;-70,78512045;-33,5643469;1
3890;314;226;36;262;-70,7828066;-33,56523795;1
3891;70;58;6;64;-70,78684432;-33,564349;1
3892;25;18;0;18;-70,76606281;-33,5651857;0
3893;41;25;0;25;-70,77670559;-33,5645196;1
3894;78;59;9;68;-70,78545693;-33,56460299;1
3895;117;75;8;83;-70,77780923;-33,56464075;1
3896;30;17;4;21;-70,77544552;-33,56459024;1
3897;20;16;0;16;-70,78644771;-33,56470658;0
3898;51;31;11;42;-70,77969991;-33,56476236;1
3899;101;69;14;83;-70,78069493;-33,5652124;1
3900;370;254;12;266;-70,7779001;-33,56503199;1
3901;63;47;0;47;-70,77570129;-33,53286643;1
3902;86;65;4;69;-70,78345026;-33,53242934;1
3903;116;93;5;98;-70,77171199;-33,53301074;1
3904;100;74;9;83;-70,78201602;-33,53254809;1
3905;26;17;0;17;-70,79635294;-33,53230744;0
3906;88;65;0;65;-70,7689275;-33,53300244;1
3907;173;136;0;136;-70,79250295;-33,53305068;1
3908;30;20;0;20;-70,79783818;-33,53235289;0
3909;108;78;8;86;-70,79209106;-33,53285168;1
3910;21;18;0;18;-70,76727979;-33,53275505;0
3911;63;43;6;49;-70,77610074;-33,53309074;1
3912;118;80;7;87;-70,79166993;-33,53282207;1
3913;112;79;16;95;-70,78022067;-33,53268069;1
3914;53;44;0;44;-70,79117754;-33,53291464;1
3915;77;59;0;59;-70,79079588;-33,53282897;1
3916;74;44;0;44;-70,79886216;-33,53251178;1
3917;56;45;0;45;-70,79042141;-33,53274298;1
3918;15;12;0;12;-70,79709482;-33,53253028;0
3919;37;31;0;31;-70,7898943;-33,53262695;1
3920;65;42;9;51;-70,77427169;-33,53307921;1
3921;102;74;10;84;-70,77822953;-33,5328135;1
3922;46;35;0;35;-70,77075557;-33,53304555;1
3923;100;79;4;83;-70,76926489;-33,53323553;1
3924;105;89;0;89;-70,78925635;-33,53334732;1
3925;152;112;11;123;-70,78887998;-33,53312772;1
3926;61;49;0;49;-70,76745761;-33,53318757;1
3927;90;73;0;73;-70,78848652;-33,53308179;1
3928;106;78;8;86;-70,78799534;-33,53319241;1
3929;111;87;0;87;-70,78764848;-33,53306258;1
3930;78;64;8;72;-70,77647963;-33,53333544;1
3931;35;23;0;23;-70,7962602;-33,53273231;1
3932;58;41;7;48;-70,78669347;-33,53289795;1
3933;20;12;0;12;-70,7979782;-33,53272863;0
3934;49;32;9;41;-70,77109469;-33,53327968;1
3935;85;67;7;74;-70,77399857;-33,53337282;1
3936;68;54;0;54;-70,78613472;-33,53312156;1
3937;75;62;6;68;-70,769605;-33,53347208;1
3938;16;0;0;0;-70,79741919;-33,53286256;0
3939;141;114;9;123;-70,78436987;-33,53333874;1
3940;90;65;12;77;-70,78380492;-33,53322336;1
3941;56;47;0;47;-70,7678287;-33,53344375;1
3942;39;32;0;32;-70,78302398;-33,5331391;1
3943;109;85;16;101;-70,77727275;-33,53333674;1
3944;48;42;0;42;-70,78973077;-33,53354597;1
3945;53;36;8;44;-70,77143663;-33,53351629;1
3946;153;104;17;121;-70,78470431;-33,5335817;1
3947;25;17;0;17;-70,79662421;-33,53305505;0
3948;101;74;9;83;-70,77372648;-33,53365382;1
3949;69;49;0;49;-70,78161962;-33,53346959;1
3950;108;76;12;88;-70,76997955;-33,53373478;1
3951;55;0;0;0;-70,78104997;-33,53340027;0
3952;101;73;11;84;-70,7686609;-33,53377538;1
3953;15;11;0;11;-70,78058217;-33,53330604;0
3954;55;45;0;45;-70,77971377;-33,533576;1
3955;85;66;6;72;-70,78197784;-33,53369183;1
3956;25;0;0;0;-70,77923075;-33,53346898;0
3957;59;44;10;54;-70,77526856;-33,5336869;1
3958;167;133;14;147;-70,78506132;-33,53380835;1
3959;66;48;5;53;-70,77179696;-33,53377013;1
3960;82;66;9;75;-70,77711874;-33,53377569;1
3961;88;65;5;70;-70,77031963;-33,53396845;1
3962;72;53;10;63;-70,78003768;-33,53381127;1
3963;103;75;15;90;-70,77344674;-33,53394289;1
3964;71;56;4;60;-70,79016037;-33,53375911;1
3965;107;73;10;83;-70,76835146;-33,53404471;1
3966;65;50;10;60;-70,78231686;-33,53392946;1
3967;131;103;10;113;-70,7875887;-33,53402538;1
3968;178;127;5;132;-70,78541899;-33,53404213;1
3969;102;73;8;81;-70,77451887;-33,53414846;1
3970;117;97;11;108;-70,77830417;-33,53438604;1
3971;98;77;7;84;-70,77066175;-33,53419847;1
3972;70;55;8;63;-70,78037775;-33,53405123;1
3973;53;45;0;45;-70,79059437;-33,53381286;1
3974;75;58;7;65;-70,77680308;-33,53410674;1
3975;115;82;15;97;-70,77242951;-33,53438999;1
3976;123;93;11;104;-70,77542127;-33,5344521;1
3977;64;53;7;60;-70,78267604;-33,53418593;1
3978;73;62;0;62;-70,78080952;-33,53427278;1
3979;101;75;5;80;-70,77489761;-33,53437831;1
3980;119;94;6;100;-70,79041649;-33,53428878;1
3981;81;66;0;66;-70,78686476;-33,5340626;1
3982;25;16;0;16;-70,75522164;-33,54073309;0
3983;94;65;14;79;-70,77104646;-33,53448489;1
3984;118;100;6;106;-70,77864731;-33,5346305;1
3985;46;35;0;35;-70,76921798;-33,53440658;1
3986;122;82;8;90;-70,77283269;-33,53462828;1
3987;74;52;8;60;-70,78300368;-33,53441139;1
3988;89;67;11;78;-70,78646999;-33,53426973;1
3989;125;89;14;103;-70,77579649;-33,53470623;1
3990;91;74;8;82;-70,78115188;-33,53451616;1
3991;300;222;19;241;-70,79005104;-33,53471867;1
3992;124;95;8;103;-70,77898417;-33,53486075;1
3993;68;51;0;51;-70,76956119;-33,53464264;1
3994;39;28;4;32;-70,77764459;-33,53454397;1
3995;51;44;0;44;-70,78908285;-33,53436667;1
3996;115;86;8;94;-70,77320927;-33,53484709;1
3997;73;44;8;52;-70,78333282;-33,53464;1
3998;72;58;0;58;-70,78610307;-33,53449085;1
3999;56;42;6;48;-70,79177598;-33,53438135;1
4000;114;88;9;97;-70,77611925;-33,53493208;1
4001;98;80;8;88;-70,78149116;-33,53475068;1
4002;113;101;0;101;-70,77931106;-33,53510754;1
4003;52;39;5;44;-70,76990141;-33,53487384;1
4004;154;127;6;133;-70,7867298;-33,53490976;1
4005;82;59;7;66;-70,78574174;-33,53469457;1
4006;95;65;12;77;-70,78366206;-33,53487484;1
4007;660;443;40;483;-70,77486721;-33,53529868;1
4008;80;60;7;67;-70,78185443;-33,53501066;1
4009;84;58;11;69;-70,78534942;-33,53490941;1
4010;48;37;0;37;-70,77032502;-33,53516291;1
4011;147;116;5;121;-70,78705112;-33,53514864;1
4012;128;98;14;112;-70,77970941;-33,53536958;1
4013;102;75;9;84;-70,77219548;-33,53523385;1
4014;47;26;13;39;-70,78400098;-33,53510802;1
4015;79;57;6;63;-70,77686269;-33,53522802;1
4016;80;60;0;60;-70,78218029;-33,5352389;1
4017;142;114;9;123;-70,78005295;-33,53560741;1
4018;121;97;6;103;-70,78879976;-33,53543539;1
4019;43;28;0;28;-70,79123734;-33,53495485;1
4020;108;90;8;98;-70,77189937;-33,5355023;1
4021;52;40;0;40;-70,79080661;-33,535076;1
4022;83;63;8;71;-70,78435946;-33,53535877;1
4023;86;65;6;71;-70,77722922;-33,53546264;1
4024;99;65;12;77;-70,78312529;-33,53541795;1
4025;50;36;0;36;-70,79041413;-33,53519771;1
4026;66;49;9;58;-70,79002367;-33,53531754;1
4027;142;102;17;119;-70,78038279;-33,53585438;1
4028;136;99;10;109;-70,78844065;-33,53564269;1
4029;73;54;10;64;-70,78962922;-33,53542867;1
4030;83;59;0;59;-70,78469175;-33,53558369;1
4031;100;72;0;72;-70,77757152;-33,53570435;1
4032;81;65;7;72;-70,77159601;-33,53577932;1
4033;62;46;0;46;-70,79164282;-33,53541928;1
4034;98;72;12;84;-70,7828573;-33,53568458;1
4035;151;111;9;120;-70,78810255;-33,53585417;1
4036;68;50;9;59;-70,7850228;-33,53581069;1
4037;126;93;9;102;-70,78075097;-33,53611661;1
4038;33;21;6;27;-70,77632538;-33,53572518;1
4039;82;68;0;68;-70,77791132;-33,53594059;1
4040;69;53;9;62;-70,77133263;-33,53608767;1
4041;104;78;6;84;-70,79196119;-33,53569892;1
4042;157;122;8;130;-70,78777364;-33,5360725;1
4043;98;74;4;78;-70,78257303;-33,53596826;1
4044;128;103;0;103;-70,78108694;-33,53633896;1
4045;56;42;6;48;-70,78535902;-33,5360341;1
4046;88;64;10;74;-70,79060927;-33,53592825;1
4047;94;69;9;78;-70,77825357;-33,53617368;1
4048;79;60;4;64;-70,77394436;-33,53636836;1
4049;62;47;0;47;-70,77688047;-33,53610698;1
4050;139;99;10;109;-70,7874344;-33,53632213;1
4051;76;57;9;66;-70,77616982;-33,53615804;1
4052;89;70;0;70;-70,78353508;-33,5361836;1
4053;113;88;10;98;-70,79225839;-33,53596072;1
4054;78;59;4;63;-70,78571037;-33,53625278;1
4055;148;116;8;124;-70,78141173;-33,53656579;1
4056;84;70;0;70;-70,78387163;-33,53640899;1
4057;145;108;8;116;-70,77581467;-33,53664688;1
4058;132;107;6;113;-70,79256108;-33,53623257;1
4059;90;66;6;72;-70,77863149;-33,53644928;1
4060;101;86;0;86;-70,79084078;-33,53625025;1
4061;141;110;8;118;-70,78172826;-33,53680878;1
4062;58;43;10;53;-70,78609299;-33,53650772;1
4063;77;58;10;68;-70,78482677;-33,53657685;1
4064;72;51;0;51;-70,77897615;-33,53668634;1
4065;48;35;0;35;-70,78969409;-33,53637219;1
4066;98;67;5;72;-70,79319181;-33,53639205;1
4067;48;32;8;40;-70,77663126;-33,53666054;1
4068;92;73;10;83;-70,79107054;-33,53654079;1
4069;154;115;10;125;-70,78206621;-33,53703573;1
4070;71;52;6;58;-70,78642588;-33,53674711;1
4071;32;27;0;27;-70,7750624;-33,53667557;1
4072;89;63;6;69;-70,77931649;-33,53692084;1
4073;105;80;6;86;-70,78455649;-33,53685189;1
4074;93;67;8;75;-70,79345521;-33,53667343;1
4075;46;32;0;32;-70,7769662;-33,53689061;1
4076;157;111;17;128;-70,78978691;-33,53704335;1
4077;20;14;0;14;-70,7900016;-33,53666136;0
4078;49;35;0;35;-70,78688514;-33,53683268;1
4079;126;89;13;102;-70,77514758;-33,53709713;1
4080;38;25;4;29;-70,78274751;-33,53697214;1
4081;69;58;5;63;-70,79135753;-33,53682068;1
4082;50;40;0;40;-70,79364151;-33,53695763;1
4083;71;53;9;62;-70,78011931;-33,53710306;1
4084;80;59;9;68;-70,77845109;-33,53720493;1
4085;205;157;12;169;-70,77428477;-33,53742733;1
4086;55;40;0;40;-70,79592321;-33,53963395;1
4087;108;83;10;93;-70,79195589;-33,5369956;1
4088;63;49;6;55;-70,78424688;-33,53711769;1
4089;46;36;4;40;-70,77730123;-33,53712947;1
4090;156;118;4;122;-70,77659403;-33,53732307;1
4091;165;129;9;138;-70,7895035;-33,53730267;1
4092;47;37;5;42;-70,78720149;-33,53705414;1
4093;235;185;10;195;-70,77508934;-33,53771193;1
4094;49;35;0;35;-70,78308289;-33,53720105;1
4095;59;47;5;52;-70,79046945;-33,53705785;1
4096;79;58;0;58;-70,78526251;-33,53734514;1
4097;80;58;12;70;-70,77936119;-33,53745982;1
4098;47;36;6;42;-70,78755266;-33,53728806;1
4099;103;83;0;83;-70,79224542;-33,53727724;1
4100;151;119;5;124;-70,78921321;-33,5375819;1
4101;90;59;8;67;-70,77802341;-33,53745205;1
4102;43;32;0;32;-70,78341521;-33,53742468;1
4103;236;177;15;192;-70,77539763;-33,53795245;1
4104;96;68;9;77;-70,78680969;-33,53746848;1
4105;62;49;4;53;-70,7856014;-33,53758162;1
4106;84;60;10;70;-70,77975749;-33,53771198;1
4107;34;26;4;30;-70,78208899;-33,53762968;1
4108;71;61;4;65;-70,78374557;-33,53765019;1
4109;69;51;8;59;-70,77774255;-33,53773704;1
4110;122;82;10;92;-70,77440627;-33,53785006;1
4111;190;148;9;157;-70,7757026;-33,53819657;1
4112;91;71;5;76;-70,79252811;-33,53755335;1
4113;150;95;23;118;-70,78033474;-33,53788175;1
4114;70;53;7;60;-70,78653105;-33,53773292;1
4115;103;81;0;81;-70,79138913;-33,53768369;1
4116;162;126;14;140;-70,78881517;-33,53796782;1
4117;51;38;0;38;-70,78276328;-33,53779634;1
4118;65;51;5;56;-70,78408686;-33,53788214;1
4119;170;121;9;130;-70,7711738;-33,53877327;1
4120;94;78;0;78;-70,77744808;-33,53806344;1
4121;178;142;5;147;-70,78069312;-33,53814407;1
4122;241;193;14;207;-70,77601675;-33,53843881;1
4123;84;62;0;62;-70,77888749;-33,53805075;1
4124;82;62;5;67;-70,79106274;-33,53791451;1
4125;68;50;9;59;-70,78624899;-33,5379959;1
4126;147;113;11;124;-70,78850013;-33,53821432;1
4127;150;121;11;132;-70,78416772;-33,53844914;1
4128;134;101;9;110;-70,78106611;-33,53839824;1
4129;78;60;0;60;-70,77858696;-33,53832177;1
4130;149;114;9;123;-70,78823035;-33,53847408;1
4131;74;61;0;61;-70,79074527;-33,53815248;1
4132;77;53;11;64;-70,7859498;-33,53827734;1
4133;250;202;9;211;-70,77636458;-33,5387147;1
4134;45;35;4;39;-70,78309325;-33,53830512;1
4135;172;119;12;131;-70,7845096;-33,53868738;1
4136;163;127;9;136;-70,78143135;-33,53865376;1
4137;104;81;5;86;-70,78699008;-33,53854429;1
4138;124;90;10;100;-70,77824983;-33,538769;1
4139;200;157;9;166;-70,77667567;-33,53895663;1
4140;76;57;6;63;-70,79045472;-33,53843371;1
4141;33;25;0;25;-70,78343607;-33,53853517;1
4142;75;44;11;55;-70,78561726;-33,53859126;1
4143;115;87;7;94;-70,77912476;-33,53886467;1
4144;151;111;14;125;-70,78182754;-33,53892808;1
4145;99;82;4;86;-70,7873299;-33,53878082;1
4146;54;40;5;45;-70,76814486;-33,53970604;1
4147;234;193;13;206;-70,77697868;-33,53919846;1
4148;200;159;4;163;-70,77947847;-33,53912957;1
4149;36;27;0;27;-70,78533558;-33,53886827;1
4150;98;75;7;82;-70,78216092;-33,53915699;1
4151;68;52;0;52;-70,78959538;-33,53885847;1
4152;89;70;7;77;-70,78764983;-33,53900418;1
4153;73;51;7;58;-70,77353475;-33,53945934;1
4154;64;51;0;51;-70,78505069;-33,53913219;1
4155;171;127;13;140;-70,77984573;-33,53938733;1
4156;98;78;10;88;-70,78246862;-33,53939189;1
4157;32;30;0;30;-70,78991219;-33,53909369;1
4158;86;70;4;74;-70,78796463;-33,53923014;1
4159;136;93;11;104;-70,77300045;-33,5396002;1
4160;153;116;12;128;-70,78580651;-33,5395805;1
4161;158;120;8;128;-70,77270434;-33,5397364;1
4162;196;150;9;159;-70,78021242;-33,53964768;1
4163;45;33;6;39;-70,78445213;-33,53935299;1
4164;84;65;8;73;-70,78829709;-33,53944907;1
4165;107;83;13;96;-70,78281955;-33,53966151;1
4166;39;27;6;33;-70,79023393;-33,53933489;1
4167;174;129;5;134;-70,77240844;-33,53987511;1
4168;140;114;0;114;-70,78613557;-33,53982423;1
4169;248;186;13;199;-70,7788614;-33,53990535;1
4170;26;21;0;21;-70,78872049;-33,53958111;1
4171;163;120;8;128;-70,77211157;-33,54001114;1
4172;48;39;4;43;-70,79100123;-33,53947745;1
4173;118;85;10;95;-70,7831284;-33,53989267;1
4174;36;31;0;31;-70,78485749;-33,53962688;1
4175;172;139;11;150;-70,78061039;-33,53995483;1
4176;142;98;15;113;-70,77181493;-33,54014689;1
4177;124;95;10;105;-70,78646105;-33,54004137;1
4178;239;169;15;184;-70,77855473;-33,540171;1
4179;131;99;16;115;-70,78344479;-33,54011784;1
4180;160;126;0;126;-70,77151606;-33,54027961;1
4181;106;71;6;77;-70,78890454;-33,53984142;1
4182;488;339;26;365;-70,77239681;-33,54100028;1
4183;117;91;8;99;-70,78094345;-33,54021383;1
4184;90;73;0;73;-70,7870573;-33,54000723;1
4185;141;99;8;107;-70,77116207;-33,54043846;1
4186;30;22;0;22;-70,78958681;-33,53980587;1
4187;181;126;18;144;-70,78428186;-33,54006433;1
4188;239;188;10;198;-70,77825225;-33,54042768;1
4189;66;40;8;48;-70,79038;-33,53997985;1
4190;19;0;0;0;-70,76276109;-33,54309145;0
4191;179;129;8;137;-70,79227311;-33,54259006;1
4192;131;96;7;103;-70,7812452;-33,54044507;1
4193;64;48;0;48;-70,78904522;-33,54020296;1
4194;71;50;0;50;-70,79007517;-33,54022154;1
4195;254;183;16;199;-70,77794844;-33,54068773;1
4196;32;25;0;25;-70,76995307;-33,54065846;1
4197;288;204;35;239;-70,77337599;-33,54190586;1
4198;46;37;0;37;-70,78768654;-33,54023733;1
4199;63;50;5;55;-70,78188545;-33,54071155;1
4200;76;59;0;59;-70,77342558;-33,5405217;1
4201;90;68;7;75;-70,78453088;-33,54066757;1
4202;43;32;0;32;-70,78977876;-33,54046387;1
4203;148;110;12;122;-70,78757297;-33,54080634;1
4204;113;88;4;92;-70,77029997;-33,54080596;1
4205;50;40;0;40;-70,78719047;-33,54049012;1
4206;180;137;10;147;-70,77942358;-33,54100203;1
4207;57;40;5;45;-70,77361205;-33,54080191;1
4208;65;48;8;56;-70,7849088;-33,54085286;1
4209;72;52;8;60;-70,78946779;-33,5407168;1
4210;149;107;14;121;-70,78791431;-33,54103943;1
4211;52;40;0;40;-70,78682576;-33,54068522;1
4212;72;60;0;60;-70,77279006;-33,54101778;1
4213;94;65;0;65;-70,77045844;-33,54105227;1
4214;128;98;11;109;-70,78217902;-33,54120682;1
4215;51;38;7;45;-70,78646417;-33,54089845;1
4216;60;46;4;50;-70,78127764;-33,54099391;1
4217;123;101;10;111;-70,77980034;-33,54128642;1
4218;57;44;0;44;-70,78508137;-33,54121554;1
4219;84;62;0;62;-70,78911483;-33,5410113;1
4220;146;114;7;121;-70,76920121;-33,54131369;1
4221;77;57;0;57;-70,77215773;-33,54130425;1
4222;146;112;12;124;-70,78254089;-33,54168402;1
4223;98;72;6;78;-70,77063232;-33,54132879;1
4224;429;317;26;343;-70,78089387;-33,54269844;1
4225;107;88;7;95;-70,78550465;-33,54139618;1
4226;42;33;4;37;-70,7887954;-33,54126599;1
4227;130;92;9;101;-70,76935327;-33,54156084;1
4228;18;15;0;15;-70,78359993;-33,54141462;0
4229;50;32;6;38;-70,77093516;-33,54180191;1
4230;703;510;29;539;-70,78559928;-33,5426411;1
4231;82;63;0;63;-70,78849493;-33,54151525;1
4232;163;118;7;125;-70,76952756;-33,54183548;1
4233;210;164;11;175;-70,76782943;-33,5421967;1
4234;325;245;17;262;-70,78317143;-33,54230726;1
4235;80;61;7;68;-70,78693416;-33,54171267;1
4236;49;32;6;38;-70,77598533;-33,5419239;1
4237;177;130;8;138;-70,7696961;-33,54208542;1
4238;84;59;6;65;-70,78667072;-33,5419286;1
4239;46;32;0;32;-70,78803906;-33,54184071;1
4240;48;35;8;43;-70,77725067;-33,54204659;1
4241;68;51;0;51;-70,77525547;-33,54222677;1
4242;169;127;9;136;-70,7698695;-33,54234178;1
4243;80;71;4;75;-70,78642186;-33,54211907;1
4244;166;113;17;130;-70,7715558;-33,54242764;1
4245;127;84;9;93;-70,78369398;-33,54217331;1
4246;53;38;4;42;-70,78837678;-33,54206998;1
4247;64;42;12;54;-70,77489612;-33,54239337;1
4248;65;39;15;54;-70,77682173;-33,54245779;1
4249;53;35;10;45;-70,77755159;-33,54235717;1
4250;76;61;0;61;-70,78617706;-33,54231427;1
4251;64;45;4;49;-70,77453281;-33,54255456;1
4252;185;140;5;145;-70,7700585;-33,54260911;1
4253;257;196;19;215;-70,76775523;-33,54327135;1
4254;55;38;7;45;-70,77644851;-33,54262775;1
4255;51;41;0;41;-70,78592687;-33,54250862;1
4256;57;43;8;51;-70,77417139;-33,5427115;1
4257;405;283;29;312;-70,78818488;-33,54380008;1
4258;49;33;8;41;-70,77606879;-33,54279661;1
4259;136;103;0;103;-70,77038402;-33,54286394;1
4260;161;117;9;126;-70,76860428;-33,54292733;1
4261;107;83;8;91;-70,76649216;-33,54288397;1
4262;70;44;9;53;-70,77380743;-33,5428757;1
4263;42;29;0;29;-70,77565618;-33,54298355;1
4264;82;56;7;63;-70,77169396;-33,54301739;1
4265;53;28;16;44;-70,77740422;-33,5428941;1
4266;56;45;0;45;-70,77343128;-33,54304058;1
4267;42;23;9;32;-70,77838824;-33,54286283;1
4268;136;110;4;114;-70,76665892;-33,54314696;1
4269;157;111;15;126;-70,76878764;-33,54319755;1
4270;56;46;4;50;-70,77527496;-33,54315553;1
4271;200;140;12;152;-70,7829793;-33,54368569;1
4272;60;33;13;46;-70,77300521;-33,54322652;1
4273;58;41;0;41;-70,78210167;-33,54305656;1
4274;55;38;9;47;-70,77869589;-33,54316839;1
4275;109;83;5;88;-70,76544755;-33,5433673;1
4276;59;38;0;38;-70,77188038;-33,54332162;1
4277;62;40;11;51;-70,77760914;-33,5432142;1
4278;123;90;5;95;-70,76657756;-33,54362702;1
4279;47;29;0;29;-70,77702461;-33,54351181;1
4280;146;112;7;119;-70,76906438;-33,54347993;1
4281;48;31;0;31;-70,78299664;-33,543177;1
4282;75;52;7;59;-70,77064961;-33,54349167;1
4283;47;31;0;31;-70,7765255;-33,54350047;1
4284;65;48;9;57;-70,78602258;-33,56504067;1
4285;67;47;6;53;-70,78572056;-33,56532921;1
4286;87;60;7;67;-70,78038824;-33,5654553;1
4287;125;94;14;108;-70,78315909;-33,56554152;1
4288;53;38;0;38;-70,77857584;-33,56528572;1
4289;60;48;0;48;-70,77818499;-33,56545058;1
4290;87;57;0;57;-70,77896612;-33,56556132;1
4291;41;27;0;27;-70,7758594;-33,56549925;1
4292;49;35;0;35;-70,77774543;-33,56557916;1
4293;121;91;12;103;-70,78346887;-33,56578495;1
4294;95;60;8;68;-70,77922937;-33,56581014;1
4295;91;54;20;74;-70,78199057;-33,56594853;1
4296;116;78;18;96;-70,7837753;-33,5660374;1
4297;38;31;0;31;-70,78498651;-33,56582113;1
4298;35;24;0;24;-70,77602792;-33,56586916;1
4299;70;49;8;57;-70,78117414;-33,56624277;1
4300;66;52;0;52;-70,78473126;-33,56609178;1
4301;59;39;0;39;-70,7786338;-33,56634827;1
4302;65;48;8;56;-70,78220506;-33,56635557;1
4303;50;37;0;37;-70,78442224;-33,56634207;1
4304;510;359;19;378;-70,77655119;-33,56728467;1
4305;41;29;0;29;-70,77821497;-33,56642969;1
4306;59;37;13;50;-70,78249023;-33,56660992;1
4307;50;29;10;39;-70,7841151;-33,5665948;1
4308;56;41;0;41;-70,78319777;-33,56687082;1
4309;55;41;0;41;-70,78184856;-33,56692025;1
4310;83;56;0;56;-70,77686449;-33,56702829;1
4311;77;52;11;63;-70,78369083;-33,56718008;1
4312;25;20;0;20;-70,78020785;-33,56711679;0
4313;54;37;5;42;-70,7823886;-33,56725209;1
4314;23;14;0;14;-70,77970804;-33,56735642;0
4315;52;33;12;45;-70,78277657;-33,56752541;1
4316;59;43;0;43;-70,77672829;-33,56779726;1
4317;120;83;0;83;-70,77822258;-33,56806218;1
4318;70;46;0;46;-70,77690627;-33,56809638;1
4319;66;44;0;44;-70,7784541;-33,56834842;1
4320;87;67;0;67;-70,77704469;-33,56839641;1
4321;20;14;0;14;-70,77858665;-33,56867178;0
4322;75;53;0;53;-70,77717995;-33,56869983;1
4323;72;53;0;53;-70,77731935;-33,56899829;1
4324;141;98;0;98;-70,79937006;-33,55236564;1
4325;580;409;16;425;-70,77946692;-33,56868368;1
4326;657;441;31;472;-70,7769399;-33,54740056;1
4327;49;35;0;35;-70,77738102;-33,54611688;1
4328;47;36;0;36;-70,77714857;-33,54575788;1
4329;399;269;7;276;-70,7786077;-33,54663432;1
4330;66;40;4;44;-70,77693724;-33,54543138;1
4331;113;74;0;74;-70,77863087;-33,54554273;1
4332;228;155;10;165;-70,7817985;-33,54516729;1
4333;357;247;25;272;-70,77974562;-33,54407002;1
4334;94;68;0;68;-70,78023779;-33,54481059;1
4335;237;156;22;178;-70,83057343;-33,51576485;1
4336;166;111;15;126;-70,82984234;-33,51491401;1
4337;223;144;22;166;-70,8271553;-33,5145733;1
4338;98;66;4;70;-70,76327722;-33,48388661;1
4339;91;62;0;62;-70,75945145;-33,48302258;1
4340;58;48;0;48;-70,7586197;-33,48315547;1
4341;58;41;0;41;-70,75990975;-33,48357495;1
4342;0;0;0;0;-70,76182568;-33,48312501;0
4343;17;14;0;14;-70,76219855;-33,48310327;0
4344;146;114;7;121;-70,75680077;-33,48016216;1
4345;168;123;0;123;-70,76156694;-33,47898697;1
4346;38;27;0;27;-70,76328371;-33,4798971;1
4347;57;36;0;36;-70,76029106;-33,47963032;1
4348;39;28;0;28;-70,75939715;-33,47919029;1
4349;95;60;0;60;-70,76579576;-33,48132366;1
4350;103;65;0;65;-70,7648915;-33,4813364;1
4351;99;70;0;70;-70,76440497;-33,48074799;1
4352;1117;768;42;810;-70,76832693;-33,48355618;1
4353;830;587;15;602;-70,76449509;-33,48185388;1
4354;228;160;11;171;-70,77683827;-33,48845544;1
4355;316;231;5;236;-70,77448771;-33,4852155;1
4356;98;68;0;68;-70,76839349;-33,48262282;1
4357;85;50;5;55;-70,76889709;-33,48314321;1
4358;59;42;0;42;-70,76769484;-33,48273908;1
4359;66;39;12;51;-70,73078251;-33,47484854;1
4360;196;138;36;174;-70,74622247;-33,52012744;1
4361;83;65;7;72;-70,74390846;-33,49253429;1
4362;24;20;0;20;-70,74415091;-33,49280177;0
4363;252;176;12;188;-70,73979048;-33,48556867;1
4364;346;238;16;254;-70,73913747;-33,4855425;1
4365;42;30;4;34;-70,74596184;-33,51730297;1
4366;15;12;0;12;-70,77141767;-33,52909666;0
4367;52;33;0;33;-70,78542858;-33,5130756;1
4368;811;534;43;577;-70,79782794;-33,51606286;1
4369;391;258;12;270;-70,79804334;-33,51500801;1
4370;114;81;0;81;-70,79828438;-33,51554153;1
4371;196;132;14;146;-70,79653839;-33,51318086;1
4372;87;58;0;58;-70,78784014;-33,50246302;1
4373;218;148;4;152;-70,79028939;-33,50362892;1
4374;139;92;5;97;-70,79035631;-33,50301963;1
4375;119;73;0;73;-70,78859053;-33,50342207;1
4376;131;89;0;89;-70,7887145;-33,50283097;1
4377;175;122;0;122;-70,79009457;-33,50388174;1
4378;90;62;0;62;-70,79010876;-33,50324706;1
4379;145;92;0;92;-70,78877586;-33,50255415;1
4380;129;84;5;89;-70,78865079;-33,50313267;1
4381;158;112;5;117;-70,79436157;-33,50533418;1
4382;63;44;0;44;-70,79458156;-33,50414206;1
4383;68;48;0;48;-70,79540193;-33,50419132;1
4384;351;242;33;275;-70,78671013;-33,50549965;1
4385;71;46;0;46;-70,78786539;-33,50057729;1
4386;132;90;8;98;-70,7957579;-33,51282091;1
4387;112;76;6;82;-70,79522273;-33,51291595;1
4388;128;99;5;104;-70,7943598;-33,51272937;1
4389;142;97;5;102;-70,79585766;-33,51327322;1
4390;126;86;12;98;-70,79419387;-33,51315628;1
4391;171;132;11;143;-70,79222002;-33,51198247;1
4392;117;86;7;93;-70,79373359;-33,51314012;1
4393;122;88;4;92;-70,79360138;-33,51269248;1
4394;70;50;6;56;-70,79255723;-33,51319096;1
4395;100;71;11;82;-70,79150167;-33,51256143;1
4396;129;84;4;88;-70,79228196;-33,51261201;1
4397;87;56;6;62;-70,79134528;-33,51298222;1
4398;88;67;0;67;-70,79208757;-33,513033;1
4399;146;96;0;96;-70,79652969;-33,5153058;1
4400;129;88;11;99;-70,79664661;-33,51604553;1
4401;132;95;7;102;-70,7964977;-33,51560348;1
4402;139;101;4;105;-70,79554172;-33,5156669;1
4403;130;79;9;88;-70,79496266;-33,51549663;1
4404;124;86;10;96;-70,79476601;-33,51592382;1
4405;129;84;11;95;-70,79606305;-33,51614268;1
4406;138;95;7;102;-70,79591828;-33,51569577;1
4407;123;89;4;93;-70,79619249;-33,51471773;1
4408;127;90;10;100;-70,79597147;-33,5151368;1
4409;120;89;6;95;-70,79674495;-33,5148867;1
4410;145;105;0;105;-70,79542342;-33,5146654;1
4411;113;78;10;88;-70,79478259;-33,51474732;1
4412;129;80;12;92;-70,79497343;-33,5151936;1
4413;603;386;17;403;-70,78273329;-33,50070069;1
4414;577;408;13;421;-70,78594308;-33,50147206;1
4415;94;66;0;66;-70,78580385;-33,500683;1
4416;79;57;0;57;-70,78537176;-33,50066513;1
4417;92;61;0;61;-70,78622136;-33,50067906;1
4418;38;29;0;29;-70,78403693;-33,50060562;1
4419;124;90;0;90;-70,78339343;-33,49988057;1
4420;22;16;0;16;-70,78273391;-33,50019091;0
4421;44;31;0;31;-70,78316371;-33,50033527;1
4422;45;38;0;38;-70,78359123;-33,50047436;1
4423;110;75;0;75;-70,79147576;-33,51642634;1
4424;269;186;6;192;-70,7890114;-33,52994703;1
4425;116;78;0;78;-70,78967395;-33,53193572;1
4426;32;23;0;23;-70,78870336;-33,5315217;1
4427;18;13;0;13;-70,78851154;-33,53050344;0
4428;36;29;0;29;-70,78896462;-33,53048466;1
4429;37;25;0;25;-70,78956134;-33,53145184;1
4430;83;65;8;73;-70,77690774;-33,52947881;1
4431;18;10;4;14;-70,73796197;-33,53236128;0
4432;10;0;0;0;-70,74537746;-33,54474159;0
4433;88;62;0;62;-70,75879425;-33,54733761;1
4434;212;146;0;146;-70,76171335;-33,55032582;1
4435;173;117;4;121;-70,7615996;-33,55106841;1
4436;55;34;0;34;-70,77840147;-33,54519261;1
4437;110;75;5;80;-70,77819281;-33,54486534;1
4438;526;382;21;403;-70,76206378;-33,55346618;1
4439;58;43;8;51;-70,76002294;-33,560847;1
4440;55;47;0;47;-70,75672032;-33,55586477;1
4441;132;96;6;102;-70,77343978;-33,53600745;1
4442;148;102;12;114;-70,77273437;-33,53677045;1
4443;74;55;4;59;-70,7731419;-33,53651051;1
4444;75;52;4;56;-70,77283524;-33,53625748;1
4445;96;58;4;62;-70,77413705;-33,53539369;1
4446;84;67;0;67;-70,77462351;-33,53569107;1
4447;130;91;4;95;-70,77428348;-33,53655334;1
4448;81;62;0;62;-70,77464805;-33,53614972;1
4449;62;42;5;47;-70,7744897;-33,53627362;1
4450;88;64;0;64;-70,77393136;-33,53699889;1
4451;75;53;0;53;-70,77345123;-33,53741255;1
4452;66;49;6;55;-70,77288132;-33,53702753;1
4453;77;53;4;57;-70,7733578;-33,53661166;1
4454;81;56;0;56;-70,77297518;-33,5363789;1
4455;96;66;4;70;-70,78535469;-33,54346721;1
4456;187;126;0;126;-70,78686427;-33,54669376;1
4457;53;41;0;41;-70,78743004;-33,54717862;1
4458;67;45;0;45;-70,78839201;-33,54639459;1
4459;60;45;0;45;-70,78806996;-33,54665884;1
4460;69;44;0;44;-70,78775674;-33,54691132;1
4461;0;0;0;0;-70,79215398;-33,53895089;0
4462;167;111;0;111;-70,79272749;-33,53960418;1
4463;104;73;0;73;-70,79375309;-33,53854727;1
4464;200;128;0;128;-70,79060715;-33,54502434;1
4465;412;281;16;297;-70,79008539;-33,54562476;1
4466;97;72;0;72;-70,79191852;-33,54589124;1
4467;66;44;0;44;-70,7903537;-33,54712821;1
4468;9;9;0;9;-70,79012058;-33,54646747;0
4469;56;40;0;40;-70,79041069;-33,54623748;1
4470;32;23;0;23;-70,79068943;-33,54601261;1
4471;16;12;0;12;-70,79123983;-33,54514605;0
4472;58;43;0;43;-70,79150253;-33,54531947;1
4473;46;33;0;33;-70,79178241;-33,54551802;1
4474;494;326;9;335;-70,79269228;-33,54820201;1
4475;57;42;0;42;-70,79450241;-33,53407648;1
4476;64;45;0;45;-70,79780881;-33,53453072;1
4477;52;37;0;37;-70,79919441;-33,53418753;1
4478;59;42;0;42;-70,79960247;-33,5344052;1
4479;160;109;0;109;-70,79962207;-33,53318742;1
4480;41;31;0;31;-70,79889677;-33,53325171;1
4481;43;31;0;31;-70,7990037;-33,53356163;1
4482;41;28;0;28;-70,79911505;-33,53386698;1
4483;76;58;0;58;-70,79730824;-33,5332686;1
4484;42;31;0;31;-70,79825898;-33,53357317;1
4485;79;56;0;56;-70,79814194;-33,53513267;1
4486;52;41;0;41;-70,79737686;-33,53505623;1
4487;33;24;0;24;-70,79670315;-33,5339544;1
4488;29;19;4;23;-70,7978742;-33,53366817;1
4489;37;25;0;25;-70,7975037;-33,53375899;1
4490;34;24;0;24;-70,79709525;-33,53385801;1
4491;44;32;0;32;-70,79707257;-33,53439452;1
4492;34;23;0;23;-70,79717985;-33,53472215;1
4493;44;32;0;32;-70,79852863;-33,53426918;1
4494;29;23;0;23;-70,79816463;-33,53440325;1
4495;59;35;0;35;-70,775457;-33,56873816;1
4496;60;41;0;41;-70,77477631;-33,56894012;1
4497;177;119;7;126;-70,77586429;-33,56849529;1
4498;279;196;10;206;-70,76734341;-33,56885547;1
4499;212;155;0;155;-70,78110558;-33,56793019;1
4500;113;78;7;85;-70,77931481;-33,56748512;1
4501;102;73;11;84;-70,78030679;-33,56659519;1
4502;318;238;23;261;-70,78159124;-33,56723196;1
4503;140;109;15;124;-70,79136545;-33,55441293;1
4504;539;432;37;469;-70,7941202;-33,55385941;1
4505;178;141;16;157;-70,78884781;-33,55570876;1
4506;169;124;18;142;-70,78629016;-33,55707501;1
4507;152;120;9;129;-70,78426957;-33,55786657;1
4508;985;690;60;750;-70,77682449;-33,56154494;1
4509;234;178;19;197;-70,78671088;-33,56519789;1
4510;0;0;0;0;-70,76689491;-33,49100065;0
4511;563;389;15;404;-70,7808621;-33,50198303;1
4512;456;320;12;332;-70,79462206;-33,55156284;1
4513;94;61;4;65;-70,78851636;-33,54775009;1
4514;43;28;7;35;-70,72954614;-33,47425158;1
4515;138;95;6;101;-70,79771834;-33,52758339;1
4516;66;42;5;47;-70,74855834;-33,54644651;1
4517;609;405;25;430;-70,78172471;-33,55949228;1
4518;221;152;0;152;-70,76189812;-33,5466248;1
4519;150;111;0;111;-70,80008717;-33,53704685;1
4520;29;26;0;26;-70,76990727;-33,53731331;1
4521;57;47;0;47;-70,7954083;-33,50450264;1
4522;0;0;0;0;-70,79648291;-33,53558523;0
4523;0;0;0;0;-70,79605349;-33,53564287;0
4524;0;0;0;0;-70,79533232;-33,53561018;0
4525;163;118;6;124;-70,77500845;-33,53591724;1
4526;78;60;4;64;-70,77306339;-33,53716158;1
4527;75;54;5;59;-70,77326985;-33,53730195;1
4528;84;55;5;60;-70,77354034;-33,53674541;1
4529;38;30;0;30;-70,78027308;-33,56765791;1
4530;153;114;6;120;-70,779556;-33,56807918;1
4531;103;78;5;83;-70,76413062;-33,54659508;1
4532;105;74;5;79;-70,79405509;-33,5219145;1
4533;120;77;8;85;-70,79394622;-33,52146528;1
4534;135;97;4;101;-70,79338866;-33,52156588;1
4535;210;152;9;161;-70,79264675;-33,5198665;1
4536;253;180;15;195;-70,79312826;-33,51676755;1
4537;84;57;7;64;-70,79235552;-33,51626851;1
4538;152;114;5;119;-70,7923671;-33,51651636;1
4539;192;134;8;142;-70,7917356;-33,51701225;1
4540;121;90;8;98;-70,7919361;-33,51645003;1
4541;116;83;0;83;-70,79171618;-33,51643891;1
4542;254;174;15;189;-70,79317305;-33,51234607;1
4543;130;85;4;89;-70,79309986;-33,5127935;1
4544;120;81;5;86;-70,79318418;-33,51323224;1
4545;85;59;0;59;-70,79175813;-33,51301342;1
4546;103;71;10;81;-70,79489281;-33,51289938;1
4547;112;84;7;91;-70,79535332;-33,51337314;1
4548;162;119;4;123;-70,79689946;-33,50667997;1
4549;170;118;12;130;-70,78654691;-33,50736035;1
4550;99;60;0;60;-70,78743211;-33,50394445;1
4551;278;189;4;193;-70,78327856;-33,50346251;1
4552;138;101;0;101;-70,78357519;-33,5030549;1
4553;41;24;11;35;-70,7741208;-33,49795461;1
4554;68;52;0;52;-70,76350695;-33,49357868;1
4555;114;70;28;98;-70,76080986;-33,50987766;1
4556;38;0;22;22;-70,76233916;-33,51129767;1
4557;31;19;0;19;-70,82542206;-33,51317882;0
4558;293;175;75;250;-70,74843929;-33,49543618;1
4559;14;6;6;12;-70,75638038;-33,50976027;0
4560;46;27;13;40;-70,74204483;-33,5132124;1
4561;58;38;10;48;-70,75072545;-33,51793713;1
4562;39;30;0;30;-70,75647983;-33,51231876;1
4563;244;160;41;201;-70,73714389;-33,51388412;1
4564;10;10;0;10;-70,74570274;-33,52727727;0
4565;59;43;0;43;-70,77477683;-33,54338183;1
4566;52;42;0;42;-70,76656053;-33,52853844;1
4567;115;81;8;89;-70,78565443;-33,51217679;1
4568;405;282;9;291;-70,77907258;-33,50145317;1
4569;101;72;5;77;-70,77856616;-33,51030057;1
4570;22;15;0;15;-70,79458439;-33,50062475;0
4571;145;100;15;115;-70,78873616;-33,51156602;1
4572;484;336;13;349;-70,79579658;-33,51406074;1
4573;129;89;11;100;-70,78340201;-33,51226722;1
4574;41;31;0;31;-70,77628869;-33,51083756;1
4575;68;50;7;57;-70,76848943;-33,51443572;1
4576;97;56;31;87;-70,76988262;-33,51700231;1
4577;37;24;6;30;-70,76531357;-33,51124467;1
4578;27;21;0;21;-70,75861074;-33,49312131;1
4579;273;182;51;233;-70,76247786;-33,50849761;1
4580;101;70;15;85;-70,77033847;-33,50472027;1
4581;12;7;0;7;-70,77631686;-33,5029711;0
4582;10;0;0;0;-70,7763987;-33,50248536;0
4583;104;63;23;86;-70,76524214;-33,49775245;1
4584;21;16;0;16;-70,76122509;-33,4830569;0
4585;144;118;9;127;-70,76024692;-33,48637014;1
4586;11;8;0;8;-70,75314476;-33,49014694;0
4587;59;41;0;41;-70,77947751;-33,49104616;1
4588;318;223;16;239;-70,76455579;-33,49100946;1
4589;263;186;19;205;-70,78349224;-33,52560576;1
4590;249;174;17;191;-70,78334305;-33,51761235;1
4591;62;52;0;52;-70,77703776;-33,53241239;1
4592;90;72;0;72;-70,78662648;-33,5192601;1
4593;302;224;0;224;-70,80056817;-33,54836814;1
4594;136;114;4;118;-70,74904733;-33,47020879;1
4595;98;70;11;81;-70,74310306;-33,46963532;1
4596;54;38;7;45;-70,73787032;-33,4757518;1
4597;55;44;0;44;-70,73927236;-33,48242759;1
4598;174;129;11;140;-70,73273529;-33,48199428;1
4599;32;30;0;30;-70,7300858;-33,47240725;1
4600;73;61;0;61;-70,72524801;-33,47998277;1
4601;106;80;13;93;-70,72789663;-33,48229589;1
4602;59;44;7;51;-70,78687441;-33,5605056;1
4603;350;247;12;259;-70,78204463;-33,56473955;1
4604;58;41;0;41;-70,77359952;-33,56760083;1
4605;137;81;26;107;-70,78500046;-33,55501475;1
